30 100
AAAGGTGTCCGGTCCGAGAAACCATATGTT|CGCTCATGTGAGGTGTCGCTCAAAAGACTC
GCGGGTCATGTGGGGGTCTAGACAGGGTCC|TATGATAATGTCGAATAAGTCCGAGAAACC
CTTGCGCTAACCCGACGTTGAGTCCGAGAA|ACCCGTTTCGTGTCTTGGACCGAGATTGGC
GCTAACCCGACGTTGAGTCCGAGAAACCAT|TTTCGTGTCTTGGACCGAGATTGGCCGAAC
CTATCATTTACAAAACTCAGCGCTCATGTG|TCTTATCCGCCACTCATGTAATACACGTTG
AGCAGAGTTCTCAATTTGTCGTGGTCCGAG|CGGTCCGAGAAACCATATGTTATGATAATG
GTCCGAGAAACCATATGTTATGATAATGTC|TAAATGTGCTTATATCAGGGTCCCTGAGCA
CGTTTCGTGTCTTGGACCGAGATTGGCCGA|CCGGATGTGTAGCCACCCACAAAGGTGTCC
CATGTGGGGGTCTAGACAGGGTCCGAGAAA|AATGTCGAATAAGTCCGAGAAACCATATGT
GATTGGCCGAACATGTAGGAATCCATGTGA|AAAGGTGTCCGGTCCGAGAAACCATATGTT
GTCTACTGTAGTAGCCGGGTTCGCCCAGCA|GAGACTGCAACGTAGAACGGTTTTTACGAA
TGATAATGTCGGCTACGCATTGTTCCCTCT|ATAATGTCCCGAGAAACCATATGTTATGAT
TACAAAGACCAATACCTTCACAGACGGTCC|CCATATGTTATGATAATGTCAACCATATGT
TATGATAATGTCATACACCATGCACTGGTA|AGCCGGGTTCGCCCAGCAATGCATGAGCGG
CCCGCAAGGTTCGGTCAGTTGGGACAACGT|TTGGAATAGCATGCCCCTCGCTTAGTGAGC
TCAGCCTGACCCGCAAGGTTCGGTCAGTTG|GTACTCGGTTTGGAATAGCATGCCCCTCGC
AGAAACCATATGTTATGATAATGTCTTCAA|GTGCTTATATCAGGGTCCCTGAGCAGATAA
GAAACCATATGTTATGATAATGTCGGCTAC|AACCATATGTTATGATAATGTCCCGAGAAA
TGATAATGTCAGAAACCATATGTTATGATA|CAAAGGTAGGGATACGCTTATATTCGCGGG
GCCGATAAAGCTCCCCAAGGGAATGTCAGT|CTGAGTTCACCGAGTCAGGAGGGCAAATAG
GTCCGAGAAACCATATGTTATGATAATGTC|CTGCAACTGCCTTTTCTCGCGCGGACACCC
TGCATGAGCGGATAGAACCGATTGCGTAGT|AAACCGCGGTCCGAGAAACCATATGTTATG
GTCCGAGAAACCATATGTTATGATAATGTC|TCATATGGCGCCAATGCGTCTGTCCACCTT
AGCCACCCACAAAGGTGTCCGGTCCGAGAA|CAAAACTCAGCGCTCATGTGAGGTGTCGCT
TAATGTCGGCTACGCATTGTTCCCTCTTAT|ATGTCCCGAGAAACCATATGTTATGATAAT
CATATGTTATGATAATGTCATACACCATGC|CTGTAGTAGCCGGGTTCGCCCAGCAATGCA
TTGCGCTAACCCGACGTTGAGTCCGAGAAA|CCCGTTTCGTGTCTTGGACCGAGATTGGCC
TGTCTTGGACCGAGATTGGCCGAACATGTA|TGTAGCCACCCACAAAGGTGTCCGGTCCGA
TCACAGACGGTCCGAGAAACCATATGTTAT|GTCAACCATATGTTATGATAATGTCCTGAC
ATGTTATGATAATGTCAACCATATGTTATG|CTTCTCATAGTCCCTCCACCAATAACGAGT
CTCGCTTAGTGAGCACCCGTTTCGTGTCTT|ATGATGTCCCTCCCGATCCGGATGTGTAGC
AACCATATGTTATGATAATGTCGGCTACGC|CCATATGTTATGATAATGTCCCGAGAAACC
CATGTAATACACGTTGGGTAAGGTTCCCTC|GGAGAAATTGACTGTGTATTTTATTATGAT
GTGAGGTGTCGCTCAAAAGACTCACAAAGG|TTGGGTAAGGTTCCCTCTCCGAGTCGCTTT
GAAACCATATGTTATGATAATGTCTAGTGC|GGTCTAGACAGGGTCCGAGAAACCATATGT
ATGATAATGTCAGAAACCATATGTTATGAT|ACAAAGGTAGGGATACGCTTATATTCGCGG
TCAACCCTGGGCTTCTCATAGTCCCTCCAC|ATAAAGCCGATAAAGCTCCCCAAGGGAATG
AACGGTTTTTACGAACAAACCGCGGTCCGA|CGATGTCAAATGGACCTAAACATTTAAATG
CGAGAAACCATATGTTATGATAATGTCCCT|ATTGGCCGAACATGTAGGAATCCATGTGAT
ATATGTTATGATAATGTCCCTCTGAGTTCA|ACATGTAGGAATCCATGTGATTGACTCCGT
ACTGCAACGTAGAACGGTTTTTACGAACAA|AATGTCTAAAGACGATGTCAAATGGACCTA
GTTTCGTGTCTTGGACCGAGATTGGCCGAA|CGGATGTGTAGCCACCCACAAAGGTGTCCG
GAGAAACCATATGTTATGATAATGTCTTAT|ATATGTTATGATAATGTCCAGGGCGGTGTT
CCTCTGAGTTCACCGAGTCAGGAGGGCAAA|GATTGACTCCGTCCGAGAAACCATATGTTA
AGGGTCCCTGAGCAGATAAAGCCGATAAAG|TATGTTATGATAATGTCCCTCTGAGTTCAC
CCATATGTTATGATAATGTCAGAAACCATA|AAAAGACTCACAAAGGTAGGGATACGCTTA
GAGAAACCATATGTTATGATAATGTCGCTA|CGATTGCGTAGTCCGAGAGTCCGAGAAACC
GTTCGGTCAGTTGGGACAACGTCTTGCGCT|GCATGCCCCTCGCTTAGTGAGCACCCGTTT
AATGTCCCTCTGAGTTCACCGAGTCAGGAG|CCATGTGATTGACTCCGTCCGAGAAACCAT
ATGTCTTCAACCCTGGGCTTCTCATAGTCC|GAGCAGATAAAGCCGATAAAGCTCCCCAAG
TCCGAGAAACCATATGTTATGATAATGTCC|CATATGGCGCCAATGCGTCTGTCCACCTTG
GGTTCCCTCTCCGAGTCGCTTTCGTCCGAG|TATTATGATTGTTGGGTTAAGGGCTGCAAC
TTGGACCGAGATTGGCCGAACATGTAGGAA|GCCACCCACAAAGGTGTCCGGTCCGAGAAA
AGCTCCCCAAGGGAATGTCAGTGCTTTACT|ACCGAGTCAGGAGGGCAAATAGCTCTGGGG
GTTGGGACAACGTCTTGCGCTAACCCGACG|TCGCTTAGTGAGCACCCGTTTCGTGTCTTG
ACGCATTGTTCCCTCTTATGTATGATGTCC|AACCATATGTTATGATAATGTCTAGTGCTC
TGGCCGAACATGTAGGAATCCATGTGATTG|GGTGTCCGGTCCGAGAAACCATATGTTATG
CTACAAAGACCAATACCTTCACAGACGGTC|ACCATATGTTATGATAATGTCAACCATATG
ATAGCTCTGGGGTACTCGGTTTGGAATAGC|ATGATAATGTCGGCTACGCATTGTTCCCTC
GGAGAAATTGACTGTGTATTTTATTATGAT|TACAGTCTGATCAGGTCAAATGGCTTGAGG
TGTCGCTCAAAAGACTCACAAAGGTAGGGA|AAGGTTCCCTCTCCGAGTCGCTTTCGTCCG
TTCTCATAGTCCCTCCACCAATAACGAGTC|AAGCTCCCCAAGGGAATGTCAGTGCTTTAC
CCATGTGATTGACTCCGTCCGAGAAACCAT|CATATGTTATGATAATGTCAGAAACCATAT
GGACCTAAACATTTAAATGTGCTTATATCA|GCTAACCCGACGTTGAGTCCGAGAAACCAT
GTAGAACGGTTTTTACGAACAAACCGCGGT|AAGACGATGTCAAATGGACCTAAACATTTA
AATTGACTGTGTATTTTATTATGATTGTTG|TCTGATCAGGTCAAATGGCTTGAGGCGGTG
GTCAGAAACCATATGTTATGATAATGTCCC|AGGGATACGCTTATATTCGCGGGTCATGTG
CGAGAGTCCGAGAAACCATATGTTATGATA|TAATGTCTTCAACCCTGGGCTTCTCATAGT
AGTCCGAGAGTCCGAGAAACCATATGTTAT|ATGATAATGTCTTCAACCCTGGGCTTCTCA
CATATGTTATGATAATGTCTAAAGACGATG|ACCCGCAAGGTTCGGTCAGTTGGGACAACG
TGTTATGATAATGTCTTATCCGCCACTCAT|TAATGTCCAGGGCGGTGTTGCCTTTGTGGA
ATGTTATGATAATGTCGGCTACGCATTGTT|GTTATGATAATGTCCCGAGAAACCATATGT
GTGAGCACCCGTTTCGTGTCTTGGACCGAG|CCTCCCGATCCGGATGTGTAGCCACCCACA
CATTGTTCCCTCTTATGTATGATGTCCCTC|CATATGTTATGATAATGTCTAGTGCTCACC
TGTTATGATAATGTCTACTGTAGTAGCCGG|CCTGACCGATACGAGACTGCAACGTAGAAC
AAGTCCGAGAAACCATATGTTATGATAATG|TCTCATATGGCGCCAATGCGTCTGTCCACC
GATAATGTCCAGGGCGGTGTTGCCTTTGTG|GTCCACCTTGGTGCCGCTGAGCCAATTGAT
GATAATGTCTAGTGCTCACCGTCACCTATC|CGAGAAACCATATGTTATGATAATGTCTTA
CCGAGAAACCATATGTTATGATAATGTCAT|TAATGTCTACTGTAGTAGCCGGGTTCGCCC
ATATGTTATGATAATGTCTTATCCGCCACT|TGATAATGTCCAGGGCGGTGTTGCCTTTGT
TATCATTTACAAAACTCAGCGCTCATGTGA|CTTATCCGCCACTCATGTAATACACGTTGG
GTCCGAGAAACCATATGTTATGATAATGTC|GAACCGATTGCGTAGTCCGAGAGTCCGAGA
ATTTGTCCGCAGCAGAGTTCTCAATTTGTC|CCTTCACAGACGGTCCGAGAAACCATATGT
TAAGGTTCCCTCTCCGAGTCGCTTTCGTCC|TTTTATTATGATTGTTGGGTTAAGGGCTGC
ATGTCCCTCCCGATCCGGATGTGTAGCCAC|GTGCTCACCGTCACCTATCATTTACAAAAC
GTCCGAGAAACCATATGTTATGATAATGTC|GAGATTGGCCGAACATGTAGGAATCCATGT
GCCCCTCGCTTAGTGAGCACCCGTTTCGTG|ATGTATGATGTCCCTCCCGATCCGGATGTG
CCTGAGCAGATAAAGCCGATAAAGCTCCCC|ATGATAATGTCCCTCTGAGTTCACCGAGTC
AATGTGCTTATATCAGGGTCCCTGAGCAGA|AGTCCGAGAAACCATATGTTATGATAATGT
ATGTAATACACGTTGGGTAAGGTTCCCTCT|GAGAAATTGACTGTGTATTTTATTATGATT
TAGTCCGAGAGTCCGAGAAACCATATGTTA|TATGATAATGTCTTCAACCCTGGGCTTCTC
AACCGATTGCGTAGTCCGAGAGTCCGAGAA|AAACCATATGTTATGATAATGTCTTCAACC
TTGCGTAGTCCGAGAGTCCGAGAAACCATA|TATGTTATGATAATGTCTTCAACCCTGGGC
TAATGTCTAAAGACGATGTCAAATGGACCT|CGGTCAGTTGGGACAACGTCTTGCGCTAAC
TATGATAATGTCGGCTACGCATTGTTCCCT|TGATAATGTCCCGAGAAACCATATGTTATG
TTTTGTGGGCTGCGGTGTCACATATTTGTC|TAATGTCGCTACAAAGACCAATACCTTCAC
TTTGGAATAGCATGCCCCTCGCTTAGTGAG|ATTGTTCCCTCTTATGTATGATGTCCCTCC
AGACGGTCCGAGAAACCATATGTTATGATA|ACCATATGTTATGATAATGTCCTGACCGAT
TGATAATGTCTAGTGCTCACCGTCACCTAT|CCGAGAAACCATATGTTATGATAATGTCTT
GTAATACACGTTGGGTAAGGTTCCCTCTCC|GAAATTGACTGTGTATTTTATTATGATTGT
TAATGTCTTCAACCCTGGGCTTCTCATAGT|CTGAGCAGATAAAGCCGATAAAGCTCCCCA
TTATCCGCCACTCATGTAATACACGTTGGG|TGTTGCCTTTGTGGAGAAATTGACTGTGTA
TATGTTATGATAATGTCATACACCATGCAC|GTAGTAGCCGGGTTCGCCCAGCAATGCATG
ATATGTTATGATAATGTCTAAAGACGATGT|CCCGCAAGGTTCGGTCAGTTGGGACAACGT
ATGATAATGTCTACTGTAGTAGCCGGGTTC|ACCGATACGAGACTGCAACGTAGAACGGTT
AATGTCCCGAGAAACCATATGTTATGATAA|GTCATGTGGGGGTCTAGACAGGGTCCGAGA
AAACATTTAAATGTGCTTATATCAGGGTCC|CCGACGTTGAGTCCGAGAAACCATATGTTA
ACTCGGTTTGGAATAGCATGCCCCTCGCTT|CTACGCATTGTTCCCTCTTATGTATGATGT
TGTCGCTACAAAGACCAATACCTTCACAGA|GAGAAACCATATGTTATGATAATGTCAACC
ATATGTTATGATAATGTCGGCTACGCATTG|ATGTTATGATAATGTCCCGAGAAACCATAT
ATGTCAGTGCTTTACTCAGCCTGACCCGCA|GCAAATAGCTCTGGGGTACTCGGTTTGGAA
GATAATGTCCCTCTGAGTTCACCGAGTCAG|AATCCATGTGATTGACTCCGTCCGAGAAAC
TCCGAGAAACCATATGTTATGATAATGTCT|AAATGTGCTTATATCAGGGTCCCTGAGCAG
AAAGCCGATAAAGCTCCCCAAGGGAATGTC|CCTCTGAGTTCACCGAGTCAGGAGGGCAAA
CTCCCCAAGGGAATGTCAGTGCTTTACTCA|CGAGTCAGGAGGGCAAATAGCTCTGGGGTA
TATGTTATGATAATGTCTACTGTAGTAGCC|GTCCTGACCGATACGAGACTGCAACGTAGA
GGTTCGCCCAGCAATGCATGAGCGGATAGA|CGGTTTTTACGAACAAACCGCGGTCCGAGA
CCCTCCCGATCCGGATGTGTAGCCACCCAC|TCACCGTCACCTATCATTTACAAAACTCAG
GGTCCGAGAAACCATATGTTATGATAATGT|TGATAATGTCTACTGTAGTAGCCGGGTTCG
ATAATGTCTAAAGACGATGTCAAATGGACC|TCGGTCAGTTGGGACAACGTCTTGCGCTAA
AGGGCGGTGTTGCCTTTGTGGAGAAATTGA|GTGCCGCTGAGCCAATTGATACAGTCTGAT
ATTGTTCCCTCTTATGTATGATGTCCCTCC|ATATGTTATGATAATGTCTAGTGCTCACCG
GTTCTCAATTTGTCGTGGTCCGAGAAACCA|GAGAAACCATATGTTATGATAATGTCTACT
AGTGCTCACCGTCACCTATCATTTACAAAA|TATGTTATGATAATGTCTTATCCGCCACTC
TTGGGTAAGGTTCCCTCTCCGAGTCGCTTT|GTGTATTTTATTATGATTGTTGGGTTAAGG
CATATGTTATGATAATGTCTAGTGCTCACC|AGACAGGGTCCGAGAAACCATATGTTATGA
TTCTCAATTTGTCGTGGTCCGAGAAACCAT|AGAAACCATATGTTATGATAATGTCTACTG
ATCAGGGTCCCTGAGCAGATAAAGCCGATA|CCATATGTTATGATAATGTCCCTCTGAGTT
AAACCATATGTTATGATAATGTCTAGTGCT|GTCTAGACAGGGTCCGAGAAACCATATGTT
ATAAAGCTCCCCAAGGGAATGTCAGTGCTT|GTTCACCGAGTCAGGAGGGCAAATAGCTCT
GCTCATGTGAGGTGTCGCTCAAAAGACTCA|TACACGTTGGGTAAGGTTCCCTCTCCGAGT
TGTCGAATAAGTCCGAGAAACCATATGTTA|ACCCCCGGTCTCATATGGCGCCAATGCGTC
CAGCAGAGTTCTCAATTTGTCGTGGTCCGA|ACGGTCCGAGAAACCATATGTTATGATAAT
ATGTCCTGACCGATACGAGACTGCAACGTA|AGAAACCATATGTTATGATAATGTCTAAAG
GTTATGATAATGTCTTCAACCCTGGGCTTC|AGGGTCCCTGAGCAGATAAAGCCGATAAAG
GAGAAACCATATGTTATGATAATGTCTAAA|CAGCCTGACCCGCAAGGTTCGGTCAGTTGG
AGCATGCCCCTCGCTTAGTGAGCACCCGTT|CTCTTATGTATGATGTCCCTCCCGATCCGG
GATAGAACCGATTGCGTAGTCCGAGAGTCC|CCGAGAAACCATATGTTATGATAATGTCTT
GTCAGTTGGGACAACGTCTTGCGCTAACCC|CCCCTCGCTTAGTGAGCACCCGTTTCGTGT
GGGCAAATAGCTCTGGGGTACTCGGTTTGG|TATGTTATGATAATGTCGGCTACGCATTGT
GTCCCTCCCGATCCGGATGTGTAGCCACCC|GCTCACCGTCACCTATCATTTACAAAACTC
GCTTAGTGAGCACCCGTTTCGTGTCTTGGA|ATGTCCCTCCCGATCCGGATGTGTAGCCAC
GAACATGTAGGAATCCATGTGATTGACTCC|CCGGTCCGAGAAACCATATGTTATGATAAT
GAGAAACCATATGTTATGATAATGTCTAGT|GGGGTCTAGACAGGGTCCGAGAAACCATAT
CTAAACATTTAAATGTGCTTATATCAGGGT|ACCCGACGTTGAGTCCGAGAAACCATATGT
ACCATATGTTATGATAATGTCTTCAACCCT|TTATATCAGGGTCCCTGAGCAGATAAAGCC
CGAACATGTAGGAATCCATGTGATTGACTC|TCCGGTCCGAGAAACCATATGTTATGATAA
AAACTCAGCGCTCATGTGAGGTGTCGCTCA|CTCATGTAATACACGTTGGGTAAGGTTCCC
ACCATATGTTATGATAATGTCGCTACAAAG|GCGTAGTCCGAGAGTCCGAGAAACCATATG
ATGTCTAAAGACGATGTCAAATGGACCTAA|GTCAGTTGGGACAACGTCTTGCGCTAACCC
GTTTGGAATAGCATGCCCCTCGCTTAGTGA|CATTGTTCCCTCTTATGTATGATGTCCCTC
CTCAGCCTGACCCGCAAGGTTCGGTCAGTT|GGTACTCGGTTTGGAATAGCATGCCCCTCG
CAACCATTTTGTGGGCTGCGGTGTCACATA|TTATGATAATGTCGCTACAAAGACCAATAC
TGTCGGCTACGCATTGTTCCCTCTTATGTA|TCCCGAGAAACCATATGTTATGATAATGTC
TGTAGCCACCCACAAAGGTGTCCGGTCCGA|TTACAAAACTCAGCGCTCATGTGAGGTGTC
TGTCATACACCATGCACTGGTAGGGGTCCG|TCGCCCAGCAATGCATGAGCGGATAGAACC
GCGGATAGAACCGATTGCGTAGTCCGAGAG|GGTCCGAGAAACCATATGTTATGATAATGT
ATATCAGGGTCCCTGAGCAGATAAAGCCGA|AACCATATGTTATGATAATGTCCCTCTGAG
TGTGAGGTGTCGCTCAAAAGACTCACAAAG|GTTGGGTAAGGTTCCCTCTCCGAGTCGCTT
CATATGTTATGATAATGTCCCTCTGAGTTC|AACATGTAGGAATCCATGTGATTGACTCCG
ATGTGATTGACTCCGTCCGAGAAACCATAT|TATGTTATGATAATGTCAGAAACCATATGT
CATTTAAATGTGCTTATATCAGGGTCCCTG|ACGTTGAGTCCGAGAAACCATATGTTATGA
ATTGCGTAGTCCGAGAGTCCGAGAAACCAT|ATATGTTATGATAATGTCTTCAACCCTGGG
AGGTGTCGCTCAAAAGACTCACAAAGGTAG|GGTAAGGTTCCCTCTCCGAGTCGCTTTCGT
TAAAGCCGATAAAGCTCCCCAAGGGAATGT|CCCTCTGAGTTCACCGAGTCAGGAGGGCAA
TGTTGCCTTTGTGGAGAAATTGACTGTGTA|TGAGCCAATTGATACAGTCTGATCAGGTCA
AGAACGGTTTTTACGAACAAACCGCGGTCC|GACGATGTCAAATGGACCTAAACATTTAAA
ATGCCCCTCGCTTAGTGAGCACCCGTTTCG|TTATGTATGATGTCCCTCCCGATCCGGATG
TCATGTAATACACGTTGGGTAAGGTTCCCT|TGGAGAAATTGACTGTGTATTTTATTATGA
TATGATAATGTCTACTGTAGTAGCCGGGTT|GACCGATACGAGACTGCAACGTAGAACGGT
TGTGTATTTTATTATGATTGTTGGGTTAAG|AGGTCAAATGGCTTGAGGCGGTGCGCGGCC
TTATGATAATGTCGGCTACGCATTGTTCCC|ATGATAATGTCCCGAGAAACCATATGTTAT
TTTACAAAACTCAGCGCTCATGTGAGGTGT|CCGCCACTCATGTAATACACGTTGGGTAAG
CCCTCTCCGAGTCGCTTTCGTCCGAGAAAC|ATGATTGTTGGGTTAAGGGCTGCAACTGCC
CCATTTTGTGGGCTGCGGTGTCACATATTT|TGATAATGTCGCTACAAAGACCAATACCTT
GAACAAACCGCGGTCCGAGAAACCATATGT|GACCTAAACATTTAAATGTGCTTATATCAG
GGGTCCCTGAGCAGATAAAGCCGATAAAGC|ATGTTATGATAATGTCCCTCTGAGTTCACC
ACCAATAACGAGTCCGAGAAACCATATGTT|TGTCAGTGCTTTACTCAGCCTGACCCGCAA
TGACTCCGTCCGAGAAACCATATGTTATGA|TGATAATGTCAGAAACCATATGTTATGATA
TCATTTACAAAACTCAGCGCTCATGTGAGG|TATCCGCCACTCATGTAATACACGTTGGGT
CACAAAGGTAGGGATACGCTTATATTCGCG|GTCGCTTTCGTCCGAGAAACCATATGTTAT
TCCCTCTCCGAGTCGCTTTCGTCCGAGAAA|TATGATTGTTGGGTTAAGGGCTGCAACTGC
TCTAGACAGGGTCCGAGAAACCATATGTTA|AAGTCCGAGAAACCATATGTTATGATAATG
CCGAGAAACCATATGTTATGATAATGTCTA|CTCAGCCTGACCCGCAAGGTTCGGTCAGTT
GAGTTCTCAATTTGTCGTGGTCCGAGAAAC|CCGAGAAACCATATGTTATGATAATGTCTA
AAACCATATGTTATGATAATGTCAACCATA|CCCTGGGCTTCTCATAGTCCCTCCACCAAT
CGAGAAACCATATGTTATGATAATGTCATA|AATGTCTACTGTAGTAGCCGGGTTCGCCCA
TCCCTGAGCAGATAAAGCCGATAAAGCTCC|TTATGATAATGTCCCTCTGAGTTCACCGAG
TGAGCGGATAGAACCGATTGCGTAGTCCGA|CGCGGTCCGAGAAACCATATGTTATGATAA
ACTGTAGTAGCCGGGTTCGCCCAGCAATGC|CTGCAACGTAGAACGGTTTTTACGAACAAA
TAATGTCATACACCATGCACTGGTAGGGGT|GGTTCGCCCAGCAATGCATGAGCGGATAGA
GACTGCAACGTAGAACGGTTTTTACGAACA|TAATGTCTAAAGACGATGTCAAATGGACCT
GCTGCGGTGTCACATATTTGTCCGCAGCAG|CTACAAAGACCAATACCTTCACAGACGGTC
AAACCATATGTTATGATAATGTCATACACC|TCTACTGTAGTAGCCGGGTTCGCCCAGCAA
GGTTTGGAATAGCATGCCCCTCGCTTAGTG|GCATTGTTCCCTCTTATGTATGATGTCCCT
TTCAACCCTGGGCTTCTCATAGTCCCTCCA|GATAAAGCCGATAAAGCTCCCCAAGGGAAT
CATGCCCCTCGCTTAGTGAGCACCCGTTTC|CTTATGTATGATGTCCCTCCCGATCCGGAT
GGATAGAACCGATTGCGTAGTCCGAGAGTC|TCCGAGAAACCATATGTTATGATAATGTCT
ACCCGTTTCGTGTCTTGGACCGAGATTGGC|GATCCGGATGTGTAGCCACCCACAAAGGTG
CAACGTAGAACGGTTTTTACGAACAAACCG|TCTAAAGACGATGTCAAATGGACCTAAACA
GCCCAGCAATGCATGAGCGGATAGAACCGA|TTTACGAACAAACCGCGGTCCGAGAAACCA
TGCACTGGTAGGGGTCCGAGAAACCATATG|GCATGAGCGGATAGAACCGATTGCGTAGTC
CCGATAAAGCTCCCCAAGGGAATGTCAGTG|TGAGTTCACCGAGTCAGGAGGGCAAATAGC
ATGATAATGTCTTATCCGCCACTCATGTAA|GTCCAGGGCGGTGTTGCCTTTGTGGAGAAA
TGATAATGTCTTCAACCCTGGGCTTCTCAT|TCCCTGAGCAGATAAAGCCGATAAAGCTCC
CATATGTTATGATAATGTCAGAAACCATAT|AAAGACTCACAAAGGTAGGGATACGCTTAT
GGTACTCGGTTTGGAATAGCATGCCCCTCG|CGGCTACGCATTGTTCCCTCTTATGTATGA
CGATACGAGACTGCAACGTAGAACGGTTTT|TGTTATGATAATGTCTAAAGACGATGTCAA
CATATGTTATGATAATGTCGAATAAGTCCG|TTTTCTCGCGCGGACACCCCCGGTCTCATA
ATGCACTGGTAGGGGTCCGAGAAACCATAT|TGCATGAGCGGATAGAACCGATTGCGTAGT
GACCGATACGAGACTGCAACGTAGAACGGT|ATATGTTATGATAATGTCTAAAGACGATGT
CCAATAACGAGTCCGAGAAACCATATGTTA|GTCAGTGCTTTACTCAGCCTGACCCGCAAG
CGGTCCGAGAAACCATATGTTATGATAATG|ATATGTTATGATAATGTCCTGACCGATACG
TCTGGGGTACTCGGTTTGGAATAGCATGCC|AATGTCGGCTACGCATTGTTCCCTCTTATG
AACGAGTCCGAGAAACCATATGTTATGATA|TGCTTTACTCAGCCTGACCCGCAAGGTTCG
CGTGTCTTGGACCGAGATTGGCCGAACATG|TGTGTAGCCACCCACAAAGGTGTCCGGTCC
TTGGGACAACGTCTTGCGCTAACCCGACGT|CGCTTAGTGAGCACCCGTTTCGTGTCTTGG
AAACCATATGTTATGATAATGTCGAATAAG|TGCCTTTTCTCGCGCGGACACCCCCGGTCT
AAAGACTCACAAAGGTAGGGATACGCTTAT|TCTCCGAGTCGCTTTCGTCCGAGAAACCAT
TCCGAGAAACCATATGTTATGATAATGTCT|ACTCAGCCTGACCCGCAAGGTTCGGTCAGT
ATATGTTATGATAATGTCTACTGTAGTAGC|TGTCCTGACCGATACGAGACTGCAACGTAG
ATCCATGTGATTGACTCCGTCCGAGAAACC|ACCATATGTTATGATAATGTCAGAAACCAT
AATGTCATACACCATGCACTGGTAGGGGTC|GTTCGCCCAGCAATGCATGAGCGGATAGAA
TGTCAGAAACCATATGTTATGATAATGTCC|TAGGGATACGCTTATATTCGCGGGTCATGT
CGGTCCGAGAAACCATATGTTATGATAATG|TTTAAATGTGCTTATATCAGGGTCCCTGAG
ATAATGTCTTATCCGCCACTCATGTAATAC|CAGGGCGGTGTTGCCTTTGTGGAGAAATTG
AGGAATCCATGTGATTGACTCCGTCCGAGA|AGAAACCATATGTTATGATAATGTCAGAAA
CCCAAGGGAATGTCAGTGCTTTACTCAGCC|GTCAGGAGGGCAAATAGCTCTGGGGTACTC
CATGTGATTGACTCCGTCCGAGAAACCATA|ATATGTTATGATAATGTCAGAAACCATATG
CCACCAATAACGAGTCCGAGAAACCATATG|AATGTCAGTGCTTTACTCAGCCTGACCCGC
TAATGTCTACTGTAGTAGCCGGGTTCGCCC|ATACGAGACTGCAACGTAGAACGGTTTTTA
CATGAGCGGATAGAACCGATTGCGTAGTCC|ACCGCGGTCCGAGAAACCATATGTTATGAT
AACATTTAAATGTGCTTATATCAGGGTCCC|CGACGTTGAGTCCGAGAAACCATATGTTAT
CACCCACAAAGGTGTCCGGTCCGAGAAACC|AACTCAGCGCTCATGTGAGGTGTCGCTCAA
ATAAGTCCGAGAAACCATATGTTATGATAA|GGTCTCATATGGCGCCAATGCGTCTGTCCA
GAAATTGACTGTGTATTTTATTATGATTGT|AGTCTGATCAGGTCAAATGGCTTGAGGCGG
AGCGGATAGAACCGATTGCGTAGTCCGAGA|CGGTCCGAGAAACCATATGTTATGATAATG
GACTCCGTCCGAGAAACCATATGTTATGAT|GATAATGTCAGAAACCATATGTTATGATAA
GTCACATATTTGTCCGCAGCAGAGTTCTCA|ACCAATACCTTCACAGACGGTCCGAGAAAC
TGAGTCCGAGAAACCATATGTTATGATAAT|ACCGAGATTGGCCGAACATGTAGGAATCCA
TGTTATGATAATGTCTTCAACCCTGGGCTT|CAGGGTCCCTGAGCAGATAAAGCCGATAAA
ACCAATACCTTCACAGACGGTCCGAGAAAC|TTATGATAATGTCAACCATATGTTATGATA
GTTATGATAATGTCAGAAACCATATGTTAT|CTCACAAAGGTAGGGATACGCTTATATTCG
AATTTGTCGTGGTCCGAGAAACCATATGTT|CCATATGTTATGATAATGTCTACTGTAGTA
TATGATAATGTCTTATCCGCCACTCATGTA|TGTCCAGGGCGGTGTTGCCTTTGTGGAGAA
AACCATATGTTATGATAATGTCTTCAACCC|CTTATATCAGGGTCCCTGAGCAGATAAAGC
AAACCATATGTTATGATAATGTCCCGAGAA|TACGCTTATATTCGCGGGTCATGTGGGGGT
CCATATGTTATGATAATGTCGCTACAAAGA|CGTAGTCCGAGAGTCCGAGAAACCATATGT
GGGGTCCGAGAAACCATATGTTATGATAAT|ATAGAACCGATTGCGTAGTCCGAGAGTCCG
CACCTATCATTTACAAAACTCAGCGCTCAT|ATGTCTTATCCGCCACTCATGTAATACACG
TGTCAAATGGACCTAAACATTTAAATGTGC|CGTCTTGCGCTAACCCGACGTTGAGTCCGA
AATGTCGCTACAAAGACCAATACCTTCACA|CCGAGAAACCATATGTTATGATAATGTCAA
GGGGGTCTAGACAGGGTCCGAGAAACCATA|CGAATAAGTCCGAGAAACCATATGTTATGA
CCGGGTTCGCCCAGCAATGCATGAGCGGAT|GAACGGTTTTTACGAACAAACCGCGGTCCG
TGCGGTGTCACATATTTGTCCGCAGCAGAG|ACAAAGACCAATACCTTCACAGACGGTCCG
TGATAATGTCTACTGTAGTAGCCGGGTTCG|CCGATACGAGACTGCAACGTAGAACGGTTT
TGGGCTTCTCATAGTCCCTCCACCAATAAC|CGATAAAGCTCCCCAAGGGAATGTCAGTGC
GTCGCTCAAAAGACTCACAAAGGTAGGGAT|AGGTTCCCTCTCCGAGTCGCTTTCGTCCGA
AGTCAGGAGGGCAAATAGCTCTGGGGTACT|AGAAACCATATGTTATGATAATGTCGGCTA
AGAGTTCTCAATTTGTCGTGGTCCGAGAAA|TCCGAGAAACCATATGTTATGATAATGTCT
CCGAGAGTCCGAGAAACCATATGTTATGAT|ATAATGTCTTCAACCCTGGGCTTCTCATAG
ATGTTATGATAATGTCTTATCCGCCACTCA|ATAATGTCCAGGGCGGTGTTGCCTTTGTGG
GTCCGAGAAACCATATGTTATGATAATGTC|TCTTCAACCCTGGGCTTCTCATAGTCCCTC
ATGTCCCTCTGAGTTCACCGAGTCAGGAGG|CATGTGATTGACTCCGTCCGAGAAACCATA
AAGACTCACAAAGGTAGGGATACGCTTATA|CTCCGAGTCGCTTTCGTCCGAGAAACCATA
AATGTCCTGACCGATACGAGACTGCAACGT|GAGAAACCATATGTTATGATAATGTCTAAA
TGCGTAGTCCGAGAGTCCGAGAAACCATAT|ATGTTATGATAATGTCTTCAACCCTGGGCT
CCATATGTTATGATAATGTCAACCATATGT|TGGGCTTCTCATAGTCCCTCCACCAATAAC
CGCTTATATTCGCGGGTCATGTGGGGGTCT|AAACCATATGTTATGATAATGTCGAATAAG
GCGGTCCGAGAAACCATATGTTATGATAAT|ATTTAAATGTGCTTATATCAGGGTCCCTGA
GAGAGTCCGAGAAACCATATGTTATGATAA|AATGTCTTCAACCCTGGGCTTCTCATAGTC
ACGTCTTGCGCTAACCCGACGTTGAGTCCG|GAGCACCCGTTTCGTGTCTTGGACCGAGAT
CCTGGGCTTCTCATAGTCCCTCCACCAATA|GCCGATAAAGCTCCCCAAGGGAATGTCAGT
CGATGTCAAATGGACCTAAACATTTAAATG|CAACGTCTTGCGCTAACCCGACGTTGAGTC
AATGTCTTCAACCCTGGGCTTCTCATAGTC|TGAGCAGATAAAGCCGATAAAGCTCCCCAA
AACCATATGTTATGATAATGTCTAAAGACG|CTGACCCGCAAGGTTCGGTCAGTTGGGACA
TACTGTAGTAGCCGGGTTCGCCCAGCAATG|ACTGCAACGTAGAACGGTTTTTACGAACAA
ATGTCCAGGGCGGTGTTGCCTTTGTGGAGA|ACCTTGGTGCCGCTGAGCCAATTGATACAG
TAGTGAGCACCCGTTTCGTGTCTTGGACCG|TCCCTCCCGATCCGGATGTGTAGCCACCCA
GCCTGACCCGCAAGGTTCGGTCAGTTGGGA|CTCGGTTTGGAATAGCATGCCCCTCGCTTA
TGAGCACCCGTTTCGTGTCTTGGACCGAGA|CTCCCGATCCGGATGTGTAGCCACCCACAA
TCCTGACCGATACGAGACTGCAACGTAGAA|AACCATATGTTATGATAATGTCTAAAGACG
AACCATATGTTATGATAATGTCGAATAAGT|GCCTTTTCTCGCGCGGACACCCCCGGTCTC
CCGAGAAACCATATGTTATGATAATGTCTA|GTTATGATAATGTCCTGACCGATACGAGAC
TCCGTCCGAGAAACCATATGTTATGATAAT|AATGTCAGAAACCATATGTTATGATAATGT
CCAGCAATGCATGAGCGGATAGAACCGATT|TACGAACAAACCGCGGTCCGAGAAACCATA
ATGTGTAGCCACCCACAAAGGTGTCCGGTC|CATTTACAAAACTCAGCGCTCATGTGAGGT
TGATTGACTCCGTCCGAGAAACCATATGTT|GTTATGATAATGTCAGAAACCATATGTTAT
GGTGTCCGGTCCGAGAAACCATATGTTATG|TCATGTGAGGTGTCGCTCAAAAGACTCACA
GGGTCATGTGGGGGTCTAGACAGGGTCCGA|TGATAATGTCGAATAAGTCCGAGAAACCAT
TAACCCGACGTTGAGTCCGAGAAACCATAT|TCGTGTCTTGGACCGAGATTGGCCGAACAT
AACCATATGTTATGATAATGTCTACTGTAG|ATAATGTCCTGACCGATACGAGACTGCAAC
AATGTCTAAAGACGATGTCAAATGGACCTA|GGTCAGTTGGGACAACGTCTTGCGCTAACC
ATATGTTATGATAATGTCTTCAACCCTGGG|TATCAGGGTCCCTGAGCAGATAAAGCCGAT
CGAGAAACCATATGTTATGATAATGTCTAC|TTATGATAATGTCCTGACCGATACGAGACT
TTTGTGGGCTGCGGTGTCACATATTTGTCC|AATGTCGCTACAAAGACCAATACCTTCACA
AGAAACCATATGTTATGATAATGTCCCGAG|GATACGCTTATATTCGCGGGTCATGTGGGG
GAGACTGCAACGTAGAACGGTTTTTACGAA|GATAATGTCTAAAGACGATGTCAAATGGAC
ATAACGAGTCCGAGAAACCATATGTTATGA|AGTGCTTTACTCAGCCTGACCCGCAAGGTT
GGTGTTGCCTTTGTGGAGAAATTGACTGTG|GCTGAGCCAATTGATACAGTCTGATCAGGT
TGTAATACACGTTGGGTAAGGTTCCCTCTC|AGAAATTGACTGTGTATTTTATTATGATTG
TGTTATGATAATGTCTAGTGCTCACCGTCA|AGGGTCCGAGAAACCATATGTTATGATAAT
TCCGAGAGTCCGAGAAACCATATGTTATGA|GATAATGTCTTCAACCCTGGGCTTCTCATA
TGGAGAAATTGACTGTGTATTTTATTATGA|ATACAGTCTGATCAGGTCAAATGGCTTGAG
GGACCGAGATTGGCCGAACATGTAGGAATC|CACCCACAAAGGTGTCCGGTCCGAGAAACC
ACCATATGTTATGATAATGTCTAAAGACGA|TGACCCGCAAGGTTCGGTCAGTTGGGACAA
TCCGAGAAACCATATGTTATGATAATGTCG|AACCGATTGCGTAGTCCGAGAGTCCGAGAA
CGAGTCAGGAGGGCAAATAGCTCTGGGGTA|CGAGAAACCATATGTTATGATAATGTCGGC
TCCGAGAAACCATATGTTATGATAATGTCA|CTTCAACCCTGGGCTTCTCATAGTCCCTCC
GATAATGTCAGAAACCATATGTTATGATAA|AAAGGTAGGGATACGCTTATATTCGCGGGT
ATGTGAGGTGTCGCTCAAAAGACTCACAAA|CGTTGGGTAAGGTTCCCTCTCCGAGTCGCT
CGCTTAGTGAGCACCCGTTTCGTGTCTTGG|GATGTCCCTCCCGATCCGGATGTGTAGCCA
TTGGAATAGCATGCCCCTCGCTTAGTGAGC|TTGTTCCCTCTTATGTATGATGTCCCTCCC
AGTTGGGACAACGTCTTGCGCTAACCCGAC|CTCGCTTAGTGAGCACCCGTTTCGTGTCTT
TTGTCCGCAGCAGAGTTCTCAATTTGTCGT|TTCACAGACGGTCCGAGAAACCATATGTTA
ACAGGGTCCGAGAAACCATATGTTATGATA|CGAGAAACCATATGTTATGATAATGTCCAG
TATGATAATGTCCAGGGCGGTGTTGCCTTT|TCTGTCCACCTTGGTGCCGCTGAGCCAATT
AATGCATGAGCGGATAGAACCGATTGCGTA|ACAAACCGCGGTCCGAGAAACCATATGTTA
ACATTTAAATGTGCTTATATCAGGGTCCCT|GACGTTGAGTCCGAGAAACCATATGTTATG
TGCTTTACTCAGCCTGACCCGCAAGGTTCG|GCTCTGGGGTACTCGGTTTGGAATAGCATG
ACGAACAAACCGCGGTCCGAGAAACCATAT|TGGACCTAAACATTTAAATGTGCTTATATC
CCGAGATTGGCCGAACATGTAGGAATCCAT|CCACAAAGGTGTCCGGTCCGAGAAACCATA
CCGAGAAACCATATGTTATGATAATGTCCA|ATATGGCGCCAATGCGTCTGTCCACCTTGG
ATGATAATGTCTTCAACCCTGGGCTTCTCA|GTCCCTGAGCAGATAAAGCCGATAAAGCTC
TAGGGATACGCTTATATTCGCGGGTCATGT|CGTCCGAGAAACCATATGTTATGATAATGT
CTTATATCAGGGTCCCTGAGCAGATAAAGC|AGAAACCATATGTTATGATAATGTCCCTCT
TATCAGGGTCCCTGAGCAGATAAAGCCGAT|ACCATATGTTATGATAATGTCCCTCTGAGT
GAGGTGTCGCTCAAAAGACTCACAAAGGTA|GGGTAAGGTTCCCTCTCCGAGTCGCTTTCG
TGTATGATGTCCCTCCCGATCCGGATGTGT|TGTCTAGTGCTCACCGTCACCTATCATTTA
ATAATGTCGGCTACGCATTGTTCCCTCTTA|AATGTCCCGAGAAACCATATGTTATGATAA
CGCTTTCGTCCGAGAAACCATATGTTATGA|TTAAGGGCTGCAACTGCCTTTTCTCGCGCG
CGTCCGAGAAACCATATGTTATGATAATGT|GCTGCAACTGCCTTTTCTCGCGCGGACACC
AGCAATGCATGAGCGGATAGAACCGATTGC|CGAACAAACCGCGGTCCGAGAAACCATATG
CGTAGAACGGTTTTTACGAACAAACCGCGG|AAAGACGATGTCAAATGGACCTAAACATTT
GAGAAACCATATGTTATGATAATGTCGAAT|AACTGCCTTTTCTCGCGCGGACACCCCCGG
TCCGAGAAACCATATGTTATGATAATGTCG|TCAGAAACCATATGTTATGATAATGTCCCG
TGAGTTCACCGAGTCAGGAGGGCAAATAGC|GACTCCGTCCGAGAAACCATATGTTATGAT
CCGCGGTCCGAGAAACCATATGTTATGATA|ACATTTAAATGTGCTTATATCAGGGTCCCT
CCCACAAAGGTGTCCGGTCCGAGAAACCAT|CTCAGCGCTCATGTGAGGTGTCGCTCAAAA
GGCTGCGGTGTCACATATTTGTCCGCAGCA|GCTACAAAGACCAATACCTTCACAGACGGT
TGTTATGATAATGTCGGCTACGCATTGTTC|TTATGATAATGTCCCGAGAAACCATATGTT
CCTCTTATGTATGATGTCCCTCCCGATCCG|ATGATAATGTCTAGTGCTCACCGTCACCTA
TCCAGGGCGGTGTTGCCTTTGTGGAGAAAT|TTGGTGCCGCTGAGCCAATTGATACAGTCT
GGGTCCGAGAAACCATATGTTATGATAATG|TAGAACCGATTGCGTAGTCCGAGAGTCCGA
GTCTAGACAGGGTCCGAGAAACCATATGTT|TAAGTCCGAGAAACCATATGTTATGATAAT
GGGTTCGCCCAGCAATGCATGAGCGGATAG|ACGGTTTTTACGAACAAACCGCGGTCCGAG
CCATATGTTATGATAATGTCGGCTACGCAT|ATATGTTATGATAATGTCCCGAGAAACCAT
GTCAGGAGGGCAAATAGCTCTGGGGTACTC|GAAACCATATGTTATGATAATGTCGGCTAC
TCCGAGAAACCATATGTTATGATAATGTCA|ATAATGTCTACTGTAGTAGCCGGGTTCGCC
GTGATTGACTCCGTCCGAGAAACCATATGT|TGTTATGATAATGTCAGAAACCATATGTTA
CGTTGAGTCCGAGAAACCATATGTTATGAT|TGGACCGAGATTGGCCGAACATGTAGGAAT
AAGGTAGGGATACGCTTATATTCGCGGGTC|CTTTCGTCCGAGAAACCATATGTTATGATA
ACTCCGTCCGAGAAACCATATGTTATGATA|ATAATGTCAGAAACCATATGTTATGATAAT
GTTATGATAATGTCTACTGTAGTAGCCGGG|CTGACCGATACGAGACTGCAACGTAGAACG
TTACAAAACTCAGCGCTCATGTGAGGTGTC|CGCCACTCATGTAATACACGTTGGGTAAGG
TCCGGATGTGTAGCCACCCACAAAGGTGTC|CCTATCATTTACAAAACTCAGCGCTCATGT
TGCCTTTGTGGAGAAATTGACTGTGTATTT|GCCAATTGATACAGTCTGATCAGGTCAAAT
GACCGAGATTGGCCGAACATGTAGGAATCC|ACCCACAAAGGTGTCCGGTCCGAGAAACCA
CTGACCGATACGAGACTGCAACGTAGAACG|CCATATGTTATGATAATGTCTAAAGACGAT
ATGATGTCCCTCCCGATCCGGATGTGTAGC|CTAGTGCTCACCGTCACCTATCATTTACAA
ATGTATGATGTCCCTCCCGATCCGGATGTG|ATGTCTAGTGCTCACCGTCACCTATCATTT
TCACATATTTGTCCGCAGCAGAGTTCTCAA|CCAATACCTTCACAGACGGTCCGAGAAACC
TGTCGTGGTCCGAGAAACCATATGTTATGA|ATGTTATGATAATGTCTACTGTAGTAGCCG
GATGTCAAATGGACCTAAACATTTAAATGT|AACGTCTTGCGCTAACCCGACGTTGAGTCC
TAGCATGCCCCTCGCTTAGTGAGCACCCGT|CCTCTTATGTATGATGTCCCTCCCGATCCG
TGTTATGATAATGTCCCTCTGAGTTCACCG|TGTAGGAATCCATGTGATTGACTCCGTCCG
GCAAGGTTCGGTCAGTTGGGACAACGTCTT|GAATAGCATGCCCCTCGCTTAGTGAGCACC
TTCGCGGGTCATGTGGGGGTCTAGACAGGG|TGTTATGATAATGTCGAATAAGTCCGAGAA
GTTATGATAATGTCGGCTACGCATTGTTCC|TATGATAATGTCCCGAGAAACCATATGTTA
CTCAATTTGTCGTGGTCCGAGAAACCATAT|AAACCATATGTTATGATAATGTCTACTGTA
TACTCAGCCTGACCCGCAAGGTTCGGTCAG|GGGGTACTCGGTTTGGAATAGCATGCCCCT
ACCTAAACATTTAAATGTGCTTATATCAGG|TAACCCGACGTTGAGTCCGAGAAACCATAT
CAATAACGAGTCCGAGAAACCATATGTTAT|TCAGTGCTTTACTCAGCCTGACCCGCAAGG
TCGGTCAGTTGGGACAACGTCTTGCGCTAA|ATGCCCCTCGCTTAGTGAGCACCCGTTTCG
ATGATAATGTCCAGGGCGGTGTTGCCTTTG|CTGTCCACCTTGGTGCCGCTGAGCCAATTG
CATATGTTATGATAATGTCTTATCCGCCAC|ATGATAATGTCCAGGGCGGTGTTGCCTTTG
CGCGGTCCGAGAAACCATATGTTATGATAA|CATTTAAATGTGCTTATATCAGGGTCCCTG
ATATGTTATGATAATGTCGCTACAAAGACC|TAGTCCGAGAGTCCGAGAAACCATATGTTA
ACCATTTTGTGGGCTGCGGTGTCACATATT|ATGATAATGTCGCTACAAAGACCAATACCT
TGATAATGTCCTGACCGATACGAGACTGCA|GTCCGAGAAACCATATGTTATGATAATGTC
AACCATATGTTATGATAATGTCTTATCCGC|GTTATGATAATGTCCAGGGCGGTGTTGCCT
CGCTACAAAGACCAATACCTTCACAGACGG|AAACCATATGTTATGATAATGTCAACCATA
AGTCCGAGAAACCATATGTTATGATAATGT|TTACTCAGCCTGACCCGCAAGGTTCGGTCA
ACCCACAAAGGTGTCCGGTCCGAGAAACCA|ACTCAGCGCTCATGTGAGGTGTCGCTCAAA
CCATATGTTATGATAATGTCCAGGGCGGTG|CCAATGCGTCTGTCCACCTTGGTGCCGCTG
TTTGTCGTGGTCCGAGAAACCATATGTTAT|ATATGTTATGATAATGTCTACTGTAGTAGC
ACGAGACTGCAACGTAGAACGGTTTTTACG|ATGATAATGTCTAAAGACGATGTCAAATGG
AGTCCGAGAAACCATATGTTATGATAATGT|CTCATATGGCGCCAATGCGTCTGTCCACCT
TGACTGTGTATTTTATTATGATTGTTGGGT|GATCAGGTCAAATGGCTTGAGGCGGTGCGC
GATTGCGTAGTCCGAGAGTCCGAGAAACCA|CATATGTTATGATAATGTCTTCAACCCTGG
GTCAGTGCTTTACTCAGCCTGACCCGCAAG|AAATAGCTCTGGGGTACTCGGTTTGGAATA
GTCCGAGAAACCATATGTTATGATAATGTC|GATAATGTCTACTGTAGTAGCCGGGTTCGC
ATGTTATGATAATGTCTTCAACCCTGGGCT|TCAGGGTCCCTGAGCAGATAAAGCCGATAA
TCTGAGTTCACCGAGTCAGGAGGGCAAATA|TTGACTCCGTCCGAGAAACCATATGTTATG
GAGCGGATAGAACCGATTGCGTAGTCCGAG|GCGGTCCGAGAAACCATATGTTATGATAAT
TTTTACGAACAAACCGCGGTCCGAGAAACC|CAAATGGACCTAAACATTTAAATGTGCTTA
CCGAGAAACCATATGTTATGATAATGTCGG|CAGAAACCATATGTTATGATAATGTCCCGA
ATAATGTCAACCATATGTTATGATAATGTC|AGTCCCTCCACCAATAACGAGTCCGAGAAA
GATGTGTAGCCACCCACAAAGGTGTCCGGT|TCATTTACAAAACTCAGCGCTCATGTGAGG
AATGTCTTATCCGCCACTCATGTAATACAC|GGGCGGTGTTGCCTTTGTGGAGAAATTGAC
TTGAGTCCGAGAAACCATATGTTATGATAA|GACCGAGATTGGCCGAACATGTAGGAATCC
ATGTTATGATAATGTCGAATAAGTCCGAGA|TCTCGCGCGGACACCCCCGGTCTCATATGG
CGAGTCCGAGAAACCATATGTTATGATAAT|CTTTACTCAGCCTGACCCGCAAGGTTCGGT
TGTGGAGAAATTGACTGTGTATTTTATTAT|TGATACAGTCTGATCAGGTCAAATGGCTTG
AGAAACCATATGTTATGATAATGTCCAGGG|TGGCGCCAATGCGTCTGTCCACCTTGGTGC
TATGTTATGATAATGTCTAAAGACGATGTC|CCGCAAGGTTCGGTCAGTTGGGACAACGTC
ACCATATGTTATGATAATGTCCAGGGCGGT|GCCAATGCGTCTGTCCACCTTGGTGCCGCT
CCGGTCCGAGAAACCATATGTTATGATAAT|TGAGGTGTCGCTCAAAAGACTCACAAAGGT
ACAGACGGTCCGAGAAACCATATGTTATGA|CAACCATATGTTATGATAATGTCCTGACCG
ATGATAATGTCCCTCTGAGTTCACCGAGTC|GGAATCCATGTGATTGACTCCGTCCGAGAA
TAATGTCTTATCCGCCACTCATGTAATACA|AGGGCGGTGTTGCCTTTGTGGAGAAATTGA
TAGTCCCTCCACCAATAACGAGTCCGAGAA|CCCAAGGGAATGTCAGTGCTTTACTCAGCC
ATAATGTCTTCAACCCTGGGCTTCTCATAG|CCTGAGCAGATAAAGCCGATAAAGCTCCCC
TCGCTCAAAAGACTCACAAAGGTAGGGATA|GGTTCCCTCTCCGAGTCGCTTTCGTCCGAG
GGGGTACTCGGTTTGGAATAGCATGCCCCT|GTCGGCTACGCATTGTTCCCTCTTATGTAT
CCCTCTGAGTTCACCGAGTCAGGAGGGCAA|TGATTGACTCCGTCCGAGAAACCATATGTT
TAGCTCTGGGGTACTCGGTTTGGAATAGCA|TGATAATGTCGGCTACGCATTGTTCCCTCT
ATGATAATGTCTAGTGCTCACCGTCACCTA|TCCGAGAAACCATATGTTATGATAATGTCT
CCGAGAAACCATATGTTATGATAATGTCGC|ACCGATTGCGTAGTCCGAGAGTCCGAGAAA
TATGATAATGTCCCTCTGAGTTCACCGAGT|AGGAATCCATGTGATTGACTCCGTCCGAGA
GTTCCCTCTTATGTATGATGTCCCTCCCGA|TGTTATGATAATGTCTAGTGCTCACCGTCA
GTACTCGGTTTGGAATAGCATGCCCCTCGC|GGCTACGCATTGTTCCCTCTTATGTATGAT
GATAATGTCTACTGTAGTAGCCGGGTTCGC|CGATACGAGACTGCAACGTAGAACGGTTTT
TGCAACGTAGAACGGTTTTTACGAACAAAC|TGTCTAAAGACGATGTCAAATGGACCTAAA
AACCGCGGTCCGAGAAACCATATGTTATGA|AAACATTTAAATGTGCTTATATCAGGGTCC
AAACCATATGTTATGATAATGTCGGCTACG|ACCATATGTTATGATAATGTCCCGAGAAAC
ACGGTCCGAGAAACCATATGTTATGATAAT|CATATGTTATGATAATGTCCTGACCGATAC
TTATGATAATGTCAGAAACCATATGTTATG|TCACAAAGGTAGGGATACGCTTATATTCGC
TAGAACCGATTGCGTAGTCCGAGAGTCCGA|GAGAAACCATATGTTATGATAATGTCTTCA
AGCCGGGTTCGCCCAGCAATGCATGAGCGG|TAGAACGGTTTTTACGAACAAACCGCGGTC
ATGTAGGAATCCATGTGATTGACTCCGTCC|TCCGAGAAACCATATGTTATGATAATGTCA
ATATGTTATGATAATGTCCAGGGCGGTGTT|AATGCGTCTGTCCACCTTGGTGCCGCTGAG
TATGTTATGATAATGTCAACCATATGTTAT|GCTTCTCATAGTCCCTCCACCAATAACGAG
TTATGATAATGTCGAATAAGTCCGAGAAAC|CGCGCGGACACCCCCGGTCTCATATGGCGC
ACCGCGGTCCGAGAAACCATATGTTATGAT|AACATTTAAATGTGCTTATATCAGGGTCCC
GGGTCTAGACAGGGTCCGAGAAACCATATG|AATAAGTCCGAGAAACCATATGTTATGATA
TCAAAAGACTCACAAAGGTAGGGATACGCT|CCCTCTCCGAGTCGCTTTCGTCCGAGAAAC
GAATCCATGTGATTGACTCCGTCCGAGAAA|AAACCATATGTTATGATAATGTCAGAAACC
CTCACAAAGGTAGGGATACGCTTATATTCG|GAGTCGCTTTCGTCCGAGAAACCATATGTT
TTTCGTCCGAGAAACCATATGTTATGATAA|AGGGCTGCAACTGCCTTTTCTCGCGCGGAC
ATTGACTCCGTCCGAGAAACCATATGTTAT|TATGATAATGTCAGAAACCATATGTTATGA
ATTTACAAAACTCAGCGCTCATGTGAGGTG|TCCGCCACTCATGTAATACACGTTGGGTAA
AAGGGAATGTCAGTGCTTTACTCAGCCTGA|AGGAGGGCAAATAGCTCTGGGGTACTCGGT
TAATGTCCCTCTGAGTTCACCGAGTCAGGA|TCCATGTGATTGACTCCGTCCGAGAAACCA
GCTTATATTCGCGGGTCATGTGGGGGTCTA|AACCATATGTTATGATAATGTCGAATAAGT
CTGTAGTAGCCGGGTTCGCCCAGCAATGCA|TGCAACGTAGAACGGTTTTTACGAACAAAC
CAAAACTCAGCGCTCATGTGAGGTGTCGCT|CACTCATGTAATACACGTTGGGTAAGGTTC
GCAAATAGCTCTGGGGTACTCGGTTTGGAA|TGTTATGATAATGTCGGCTACGCATTGTTC
TTGTTCCCTCTTATGTATGATGTCCCTCCC|TATGTTATGATAATGTCTAGTGCTCACCGT
TAACGAGTCCGAGAAACCATATGTTATGAT|GTGCTTTACTCAGCCTGACCCGCAAGGTTC
ACCCTGGGCTTCTCATAGTCCCTCCACCAA|AAGCCGATAAAGCTCCCCAAGGGAATGTCA
AGAACCGATTGCGTAGTCCGAGAGTCCGAG|AGAAACCATATGTTATGATAATGTCTTCAA
TACACGTTGGGTAAGGTTCCCTCTCCGAGT|TTGACTGTGTATTTTATTATGATTGTTGGG
TCAAATGGACCTAAACATTTAAATGTGCTT|TCTTGCGCTAACCCGACGTTGAGTCCGAGA
AAATTGACTGTGTATTTTATTATGATTGTT|GTCTGATCAGGTCAAATGGCTTGAGGCGGT
ACAAACCGCGGTCCGAGAAACCATATGTTA|CCTAAACATTTAAATGTGCTTATATCAGGG
GCATTGTTCCCTCTTATGTATGATGTCCCT|CCATATGTTATGATAATGTCTAGTGCTCAC
GAGAAACCATATGTTATGATAATGTCAACC|CAACCCTGGGCTTCTCATAGTCCCTCCACC
ACTCAGCGCTCATGTGAGGTGTCGCTCAAA|CATGTAATACACGTTGGGTAAGGTTCCCTC
CATATGTTATGATAATGTCCAGGGCGGTGT|CAATGCGTCTGTCCACCTTGGTGCCGCTGA
AAGACGATGTCAAATGGACCTAAACATTTA|GGGACAACGTCTTGCGCTAACCCGACGTTG
AAACCATATGTTATGATAATGTCTTATCCG|TGTTATGATAATGTCCAGGGCGGTGTTGCC
CATTTACAAAACTCAGCGCTCATGTGAGGT|ATCCGCCACTCATGTAATACACGTTGGGTA
GCATGAGCGGATAGAACCGATTGCGTAGTC|AACCGCGGTCCGAGAAACCATATGTTATGA
CCGAGAAACCATATGTTATGATAATGTCAA|TTCAACCCTGGGCTTCTCATAGTCCCTCCA
GTCCGAGAAACCATATGTTATGATAATGTC|ATGTTATGATAATGTCCTGACCGATACGAG
GAAACCATATGTTATGATAATGTCAACCAT|ACCCTGGGCTTCTCATAGTCCCTCCACCAA
TGTGGGCTGCGGTGTCACATATTTGTCCGC|TGTCGCTACAAAGACCAATACCTTCACAGA
AGACTGCAACGTAGAACGGTTTTTACGAAC|ATAATGTCTAAAGACGATGTCAAATGGACC
TCCCGAGAAACCATATGTTATGATAATGTC|TGTGGGGGTCTAGACAGGGTCCGAGAAACC
CGCCACTCATGTAATACACGTTGGGTAAGG|CCTTTGTGGAGAAATTGACTGTGTATTTTA
CATATGTTATGATAATGTCCCGAGAAACCA|CTTATATTCGCGGGTCATGTGGGGGTCTAG
CGATCCGGATGTGTAGCCACCCACAAAGGT|TCACCTATCATTTACAAAACTCAGCGCTCA
ATACGAGACTGCAACGTAGAACGGTTTTTA|TTATGATAATGTCTAAAGACGATGTCAAAT
GGAATGTCAGTGCTTTACTCAGCCTGACCC|AGGGCAAATAGCTCTGGGGTACTCGGTTTG
CGAATAAGTCCGAGAAACCATATGTTATGA|CCCGGTCTCATATGGCGCCAATGCGTCTGT
TTCGCCCAGCAATGCATGAGCGGATAGAAC|GTTTTTACGAACAAACCGCGGTCCGAGAAA
CCCGTTTCGTGTCTTGGACCGAGATTGGCC|ATCCGGATGTGTAGCCACCCACAAAGGTGT
ATGTTATGATAATGTCGCTACAAAGACCAA|GTCCGAGAGTCCGAGAAACCATATGTTATG
GCACCCGTTTCGTGTCTTGGACCGAGATTG|CCGATCCGGATGTGTAGCCACCCACAAAGG
TGATAATGTCTAAAGACGATGTCAAATGGA|GTTCGGTCAGTTGGGACAACGTCTTGCGCT
ACCATATGTTATGATAATGTCTAGTGCTCA|CTAGACAGGGTCCGAGAAACCATATGTTAT
ACCTTCACAGACGGTCCGAGAAACCATATG|TAATGTCAACCATATGTTATGATAATGTCC
CCATATGTTATGATAATGTCTACTGTAGTA|AATGTCCTGACCGATACGAGACTGCAACGT
ACTGGTAGGGGTCCGAGAAACCATATGTTA|TGAGCGGATAGAACCGATTGCGTAGTCCGA
GTCACCTATCATTTACAAAACTCAGCGCTC|TAATGTCTTATCCGCCACTCATGTAATACA
CGGTCAGTTGGGACAACGTCTTGCGCTAAC|TGCCCCTCGCTTAGTGAGCACCCGTTTCGT
GTCAAATGGACCTAAACATTTAAATGTGCT|GTCTTGCGCTAACCCGACGTTGAGTCCGAG
CGTCCGAGAAACCATATGTTATGATAATGT|TGTCAGAAACCATATGTTATGATAATGTCC
AATAAGTCCGAGAAACCATATGTTATGATA|CGGTCTCATATGGCGCCAATGCGTCTGTCC
CAATACCTTCACAGACGGTCCGAGAAACCA|ATGATAATGTCAACCATATGTTATGATAAT
CCCTCCACCAATAACGAGTCCGAGAAACCA|AGGGAATGTCAGTGCTTTACTCAGCCTGAC
GTCCCTCTGAGTTCACCGAGTCAGGAGGGC|TGTGATTGACTCCGTCCGAGAAACCATATG
GTGGGCTGCGGTGTCACATATTTGTCCGCA|GTCGCTACAAAGACCAATACCTTCACAGAC
TTATGATAATGTCTTATCCGCCACTCATGT|ATGTCCAGGGCGGTGTTGCCTTTGTGGAGA
TTATATCAGGGTCCCTGAGCAGATAAAGCC|GAAACCATATGTTATGATAATGTCCCTCTG
TGACCGATACGAGACTGCAACGTAGAACGG|CATATGTTATGATAATGTCTAAAGACGATG
AACCATATGTTATGATAATGTCTAGTGCTC|TCTAGACAGGGTCCGAGAAACCATATGTTA
ACCATGCACTGGTAGGGGTCCGAGAAACCA|CAATGCATGAGCGGATAGAACCGATTGCGT
GGGCTTCTCATAGTCCCTCCACCAATAACG|GATAAAGCTCCCCAAGGGAATGTCAGTGCT
TCTTCAACCCTGGGCTTCTCATAGTCCCTC|CAGATAAAGCCGATAAAGCTCCCCAAGGGA
ATTGGCCGAACATGTAGGAATCCATGTGAT|AAGGTGTCCGGTCCGAGAAACCATATGTTA
TCGCTACAAAGACCAATACCTTCACAGACG|GAAACCATATGTTATGATAATGTCAACCAT
TAATGTCCCGAGAAACCATATGTTATGATA|GGTCATGTGGGGGTCTAGACAGGGTCCGAG
TGTCTAAAGACGATGTCAAATGGACCTAAA|TCAGTTGGGACAACGTCTTGCGCTAACCCG
CTCATGTAATACACGTTGGGTAAGGTTCCC|GTGGAGAAATTGACTGTGTATTTTATTATG
TGTTATGATAATGTCAGAAACCATATGTTA|ACTCACAAAGGTAGGGATACGCTTATATTC
ATGTCGAATAAGTCCGAGAAACCATATGTT|CACCCCCGGTCTCATATGGCGCCAATGCGT
GTGTATTTTATTATGATTGTTGGGTTAAGG|GGTCAAATGGCTTGAGGCGGTGCGCGGCCC
TTATGATAATGTCAACCATATGTTATGATA|CTCATAGTCCCTCCACCAATAACGAGTCCG
TAATACACGTTGGGTAAGGTTCCCTCTCCG|AAATTGACTGTGTATTTTATTATGATTGTT
CATATGTTATGATAATGTCGGCTACGCATT|TATGTTATGATAATGTCCCGAGAAACCATA
TCGCTTAGTGAGCACCCGTTTCGTGTCTTG|TGATGTCCCTCCCGATCCGGATGTGTAGCC
GCCGAACATGTAGGAATCCATGTGATTGAC|TGTCCGGTCCGAGAAACCATATGTTATGAT
CTGCGGTGTCACATATTTGTCCGCAGCAGA|TACAAAGACCAATACCTTCACAGACGGTCC
CTAACCCGACGTTGAGTCCGAGAAACCATA|TTCGTGTCTTGGACCGAGATTGGCCGAACA
CTTATATTCGCGGGTCATGTGGGGGTCTAG|ACCATATGTTATGATAATGTCGAATAAGTC
ATAAAGCCGATAAAGCTCCCCAAGGGAATG|TCCCTCTGAGTTCACCGAGTCAGGAGGGCA
TGATGTCCCTCCCGATCCGGATGTGTAGCC|TAGTGCTCACCGTCACCTATCATTTACAAA
GTTGCCTTTGTGGAGAAATTGACTGTGTAT|GAGCCAATTGATACAGTCTGATCAGGTCAA
GTAGGGATACGCTTATATTCGCGGGTCATG|TCGTCCGAGAAACCATATGTTATGATAATG
AGGTTCCCTCTCCGAGTCGCTTTCGTCCGA|TTATTATGATTGTTGGGTTAAGGGCTGCAA
TCTCAATTTGTCGTGGTCCGAGAAACCATA|GAAACCATATGTTATGATAATGTCTACTGT
CGCATTGTTCCCTCTTATGTATGATGTCCC|ACCATATGTTATGATAATGTCTAGTGCTCA
GGTCCGAGAAACCATATGTTATGATAATGT|AGAACCGATTGCGTAGTCCGAGAGTCCGAG
GTCGGCTACGCATTGTTCCCTCTTATGTAT|CCCGAGAAACCATATGTTATGATAATGTCT
ATGTCATACACCATGCACTGGTAGGGGTCC|TTCGCCCAGCAATGCATGAGCGGATAGAAC
TGTCTTATCCGCCACTCATGTAATACACGT|GCGGTGTTGCCTTTGTGGAGAAATTGACTG
CTTCAACCCTGGGCTTCTCATAGTCCCTCC|AGATAAAGCCGATAAAGCTCCCCAAGGGAA
AGGGTCCGAGAAACCATATGTTATGATAAT|AGAAACCATATGTTATGATAATGTCCAGGG
CATATGTTATGATAATGTCTTCAACCCTGG|ATATCAGGGTCCCTGAGCAGATAAAGCCGA
GTTCGCCCAGCAATGCATGAGCGGATAGAA|GGTTTTTACGAACAAACCGCGGTCCGAGAA
ACTCACAAAGGTAGGGATACGCTTATATTC|CGAGTCGCTTTCGTCCGAGAAACCATATGT
CTTGGACCGAGATTGGCCGAACATGTAGGA|AGCCACCCACAAAGGTGTCCGGTCCGAGAA
GCTTTCGTCCGAGAAACCATATGTTATGAT|TAAGGGCTGCAACTGCCTTTTCTCGCGCGG
TAATGTCGAATAAGTCCGAGAAACCATATG|GACACCCCCGGTCTCATATGGCGCCAATGC
AGACGATGTCAAATGGACCTAAACATTTAA|GGACAACGTCTTGCGCTAACCCGACGTTGA
TAGCCGGGTTCGCCCAGCAATGCATGAGCG|GTAGAACGGTTTTTACGAACAAACCGCGGT
GCTTCTCATAGTCCCTCCACCAATAACGAG|TAAAGCTCCCCAAGGGAATGTCAGTGCTTT
GTCGAATAAGTCCGAGAAACCATATGTTAT|CCCCCGGTCTCATATGGCGCCAATGCGTCT
GCCACCCACAAAGGTGTCCGGTCCGAGAAA|AAAACTCAGCGCTCATGTGAGGTGTCGCTC
ACTCAGCCTGACCCGCAAGGTTCGGTCAGT|GGGTACTCGGTTTGGAATAGCATGCCCCTC
ATGATAATGTCGGCTACGCATTGTTCCCTC|GATAATGTCCCGAGAAACCATATGTTATGA
AGAAACCATATGTTATGATAATGTCGAATA|ACTGCCTTTTCTCGCGCGGACACCCCCGGT
ATAGAACCGATTGCGTAGTCCGAGAGTCCG|CGAGAAACCATATGTTATGATAATGTCTTC
CTAGACAGGGTCCGAGAAACCATATGTTAT|AGTCCGAGAAACCATATGTTATGATAATGT
TAAGTCCGAGAAACCATATGTTATGATAAT|GTCTCATATGGCGCCAATGCGTCTGTCCAC
AGATAAAGCCGATAAAGCTCCCCAAGGGAA|TGTCCCTCTGAGTTCACCGAGTCAGGAGGG
CGTTGGGTAAGGTTCCCTCTCCGAGTCGCT|CTGTGTATTTTATTATGATTGTTGGGTTAA
ATGTCAGAAACCATATGTTATGATAATGTC|GTAGGGATACGCTTATATTCGCGGGTCATG
AACTCAGCGCTCATGTGAGGTGTCGCTCAA|TCATGTAATACACGTTGGGTAAGGTTCCCT
TATTTGTCCGCAGCAGAGTTCTCAATTTGT|ACCTTCACAGACGGTCCGAGAAACCATATG
AGTCCCTCCACCAATAACGAGTCCGAGAAA|CCAAGGGAATGTCAGTGCTTTACTCAGCCT
TGTCAACCATATGTTATGATAATGTCCTGA|CCTCCACCAATAACGAGTCCGAGAAACCAT
GCCTTTGTGGAGAAATTGACTGTGTATTTT|CCAATTGATACAGTCTGATCAGGTCAAATG
ATGTCCCGAGAAACCATATGTTATGATAAT|TCATGTGGGGGTCTAGACAGGGTCCGAGAA
ATATTCGCGGGTCATGTGGGGGTCTAGACA|ATATGTTATGATAATGTCGAATAAGTCCGA
GCTACAAAGACCAATACCTTCACAGACGGT|AACCATATGTTATGATAATGTCAACCATAT
ATAATGTCCCTCTGAGTTCACCGAGTCAGG|ATCCATGTGATTGACTCCGTCCGAGAAACC
TACGCATTGTTCCCTCTTATGTATGATGTC|AAACCATATGTTATGATAATGTCTAGTGCT
AGCTCTGGGGTACTCGGTTTGGAATAGCAT|GATAATGTCGGCTACGCATTGTTCCCTCTT
ATGGACCTAAACATTTAAATGTGCTTATAT|GCGCTAACCCGACGTTGAGTCCGAGAAACC
ATTTGTCGTGGTCCGAGAAACCATATGTTA|CATATGTTATGATAATGTCTACTGTAGTAG
TGGAATAGCATGCCCCTCGCTTAGTGAGCA|TGTTCCCTCTTATGTATGATGTCCCTCCCG
CAGATAAAGCCGATAAAGCTCCCCAAGGGA|ATGTCCCTCTGAGTTCACCGAGTCAGGAGG
ATTCGCGGGTCATGTGGGGGTCTAGACAGG|ATGTTATGATAATGTCGAATAAGTCCGAGA
CATGCACTGGTAGGGGTCCGAGAAACCATA|ATGCATGAGCGGATAGAACCGATTGCGTAG
TTCCCTCTTATGTATGATGTCCCTCCCGAT|GTTATGATAATGTCTAGTGCTCACCGTCAC
TCAATTTGTCGTGGTCCGAGAAACCATATG|AACCATATGTTATGATAATGTCTACTGTAG
GTCATACACCATGCACTGGTAGGGGTCCGA|CGCCCAGCAATGCATGAGCGGATAGAACCG
TGGACCTAAACATTTAAATGTGCTTATATC|CGCTAACCCGACGTTGAGTCCGAGAAACCA
AGAAACCATATGTTATGATAATGTCTAAAG|AGCCTGACCCGCAAGGTTCGGTCAGTTGGG
TACGAGACTGCAACGTAGAACGGTTTTTAC|TATGATAATGTCTAAAGACGATGTCAAATG
GTCAACCATATGTTATGATAATGTCCTGAC|CTCCACCAATAACGAGTCCGAGAAACCATA
AGAAACCATATGTTATGATAATGTCATACA|TGTCTACTGTAGTAGCCGGGTTCGCCCAGC
CCGCCACTCATGTAATACACGTTGGGTAAG|GCCTTTGTGGAGAAATTGACTGTGTATTTT
GGTCCGAGAAACCATATGTTATGATAATGT|TATGTTATGATAATGTCCTGACCGATACGA
AGCCGATAAAGCTCCCCAAGGGAATGTCAG|TCTGAGTTCACCGAGTCAGGAGGGCAAATA
CCATGCACTGGTAGGGGTCCGAGAAACCAT|AATGCATGAGCGGATAGAACCGATTGCGTA
ATAATGTCTACTGTAGTAGCCGGGTTCGCC|GATACGAGACTGCAACGTAGAACGGTTTTT
ATGATAATGTCCCGAGAAACCATATGTTAT|CGCGGGTCATGTGGGGGTCTAGACAGGGTC
GATGTCCCTCCCGATCCGGATGTGTAGCCA|AGTGCTCACCGTCACCTATCATTTACAAAA
ATGTTATGATAATGTCTAGTGCTCACCGTC|CAGGGTCCGAGAAACCATATGTTATGATAA
GCAACGTAGAACGGTTTTTACGAACAAACC|GTCTAAAGACGATGTCAAATGGACCTAAAC
CGATAAAGCTCCCCAAGGGAATGTCAGTGC|GAGTTCACCGAGTCAGGAGGGCAAATAGCT
ATCATTTACAAAACTCAGCGCTCATGTGAG|TTATCCGCCACTCATGTAATACACGTTGGG
CATACACCATGCACTGGTAGGGGTCCGAGA|CCCAGCAATGCATGAGCGGATAGAACCGAT
GTGGTCCGAGAAACCATATGTTATGATAAT|TATGATAATGTCTACTGTAGTAGCCGGGTT
ACCATATGTTATGATAATGTCGAATAAGTC|CCTTTTCTCGCGCGGACACCCCCGGTCTCA
ACAAAGGTGTCCGGTCCGAGAAACCATATG|AGCGCTCATGTGAGGTGTCGCTCAAAAGAC
ATGTCAACCATATGTTATGATAATGTCCTG|CCCTCCACCAATAACGAGTCCGAGAAACCA
CCGGATGTGTAGCCACCCACAAAGGTGTCC|CTATCATTTACAAAACTCAGCGCTCATGTG
TCCGAGAAACCATATGTTATGATAATGTCC|AGATTGGCCGAACATGTAGGAATCCATGTG
CTAAAGACGATGTCAAATGGACCTAAACAT|GTTGGGACAACGTCTTGCGCTAACCCGACG
AAGGTTCGGTCAGTTGGGACAACGTCTTGC|ATAGCATGCCCCTCGCTTAGTGAGCACCCG
ATGTGGGGGTCTAGACAGGGTCCGAGAAAC|ATGTCGAATAAGTCCGAGAAACCATATGTT
TCGCTTTCGTCCGAGAAACCATATGTTATG|GTTAAGGGCTGCAACTGCCTTTTCTCGCGC
TTATGATAATGTCTTCAACCCTGGGCTTCT|GGGTCCCTGAGCAGATAAAGCCGATAAAGC
TGTGGGGGTCTAGACAGGGTCCGAGAAACC|TGTCGAATAAGTCCGAGAAACCATATGTTA
TGGGGTACTCGGTTTGGAATAGCATGCCCC|TGTCGGCTACGCATTGTTCCCTCTTATGTA
CGAGAAACCATATGTTATGATAATGTCTTA|CATATGTTATGATAATGTCCAGGGCGGTGT
GGTCCGAGAAACCATATGTTATGATAATGT|TTAAATGTGCTTATATCAGGGTCCCTGAGC
GAGAAACCATATGTTATGATAATGTCATAC|ATGTCTACTGTAGTAGCCGGGTTCGCCCAG
GGCTACGCATTGTTCCCTCTTATGTATGAT|GAGAAACCATATGTTATGATAATGTCTAGT
GCATGCCCCTCGCTTAGTGAGCACCCGTTT|TCTTATGTATGATGTCCCTCCCGATCCGGA
CGGATGTGTAGCCACCCACAAAGGTGTCCG|TATCATTTACAAAACTCAGCGCTCATGTGA
TTATGATAATGTCCCGAGAAACCATATGTT|TTCGCGGGTCATGTGGGGGTCTAGACAGGG
GTAGTCCGAGAGTCCGAGAAACCATATGTT|TTATGATAATGTCTTCAACCCTGGGCTTCT
CGAGAAACCATATGTTATGATAATGTCGAA|CAACTGCCTTTTCTCGCGCGGACACCCCCG
GAGTTCACCGAGTCAGGAGGGCAAATAGCT|ACTCCGTCCGAGAAACCATATGTTATGATA
GTTCACCGAGTCAGGAGGGCAAATAGCTCT|TCCGTCCGAGAAACCATATGTTATGATAAT
CTCTTATGTATGATGTCCCTCCCGATCCGG|TGATAATGTCTAGTGCTCACCGTCACCTAT
TTATGATAATGTCTAGTGCTCACCGTCACC|GGTCCGAGAAACCATATGTTATGATAATGT
TACACCATGCACTGGTAGGGGTCCGAGAAA|CAGCAATGCATGAGCGGATAGAACCGATTG
AGAAATTGACTGTGTATTTTATTATGATTG|CAGTCTGATCAGGTCAAATGGCTTGAGGCG
ATAATGTCGCTACAAAGACCAATACCTTCA|GTCCGAGAAACCATATGTTATGATAATGTC
CTTCACAGACGGTCCGAGAAACCATATGTT|ATGTCAACCATATGTTATGATAATGTCCTG
GAGAAACCATATGTTATGATAATGTCCAGG|ATGGCGCCAATGCGTCTGTCCACCTTGGTG
GACGATGTCAAATGGACCTAAACATTTAAA|GACAACGTCTTGCGCTAACCCGACGTTGAG
AATGTCGGCTACGCATTGTTCCCTCTTATG|TGTCCCGAGAAACCATATGTTATGATAATG
GATACGAGACTGCAACGTAGAACGGTTTTT|GTTATGATAATGTCTAAAGACGATGTCAAA
CGAGACTGCAACGTAGAACGGTTTTTACGA|TGATAATGTCTAAAGACGATGTCAAATGGA
CCTAAACATTTAAATGTGCTTATATCAGGG|AACCCGACGTTGAGTCCGAGAAACCATATG
CTGACCCGCAAGGTTCGGTCAGTTGGGACA|CGGTTTGGAATAGCATGCCCCTCGCTTAGT
ATACCTTCACAGACGGTCCGAGAAACCATA|GATAATGTCAACCATATGTTATGATAATGT
CAAATAGCTCTGGGGTACTCGGTTTGGAAT|GTTATGATAATGTCGGCTACGCATTGTTCC
TTGCCTTTGTGGAGAAATTGACTGTGTATT|AGCCAATTGATACAGTCTGATCAGGTCAAA
GATAATGTCAACCATATGTTATGATAATGT|TAGTCCCTCCACCAATAACGAGTCCGAGAA
GCGGTGTTGCCTTTGTGGAGAAATTGACTG|CCGCTGAGCCAATTGATACAGTCTGATCAG
ATGTCTACTGTAGTAGCCGGGTTCGCCCAG|ACGAGACTGCAACGTAGAACGGTTTTTACG
GTGGGGGTCTAGACAGGGTCCGAGAAACCA|GTCGAATAAGTCCGAGAAACCATATGTTAT
GAATGTCAGTGCTTTACTCAGCCTGACCCG|GGGCAAATAGCTCTGGGGTACTCGGTTTGG
GGTCATGTGGGGGTCTAGACAGGGTCCGAG|GATAATGTCGAATAAGTCCGAGAAACCATA
GGTAAGGTTCCCTCTCCGAGTCGCTTTCGT|TATTTTATTATGATTGTTGGGTTAAGGGCT
GTCCGGTCCGAGAAACCATATGTTATGATA|TGTGAGGTGTCGCTCAAAAGACTCACAAAG
AATGTCGAATAAGTCCGAGAAACCATATGT|ACACCCCCGGTCTCATATGGCGCCAATGCG
TTTGTGGAGAAATTGACTGTGTATTTTATT|ATTGATACAGTCTGATCAGGTCAAATGGCT
CTCCGAGTCGCTTTCGTCCGAGAAACCATA|TTGTTGGGTTAAGGGCTGCAACTGCCTTTT
CGTCACCTATCATTTACAAAACTCAGCGCT|ATAATGTCTTATCCGCCACTCATGTAATAC
TACGCTTATATTCGCGGGTCATGTGGGGGT|AGAAACCATATGTTATGATAATGTCGAATA
CTCCGTCCGAGAAACCATATGTTATGATAA|TAATGTCAGAAACCATATGTTATGATAATG
CTCTGGGGTACTCGGTTTGGAATAGCATGC|TAATGTCGGCTACGCATTGTTCCCTCTTAT
TATGTTATGATAATGTCTAGTGCTCACCGT|ACAGGGTCCGAGAAACCATATGTTATGATA
GTGTCACATATTTGTCCGCAGCAGAGTTCT|AGACCAATACCTTCACAGACGGTCCGAGAA
GAGAAATTGACTGTGTATTTTATTATGATT|ACAGTCTGATCAGGTCAAATGGCTTGAGGC
GTCCGAGAGTCCGAGAAACCATATGTTATG|TGATAATGTCTTCAACCCTGGGCTTCTCAT
AAACCATATGTTATGATAATGTCGCTACAA|TTGCGTAGTCCGAGAGTCCGAGAAACCATA
CCCTCGCTTAGTGAGCACCCGTTTCGTGTC|GTATGATGTCCCTCCCGATCCGGATGTGTA
GGTCCGAGAAACCATATGTTATGATAATGT|AGGTGTCGCTCAAAAGACTCACAAAGGTAG
ATGATAATGTCTAAAGACGATGTCAAATGG|GGTTCGGTCAGTTGGGACAACGTCTTGCGC
CCGAGTCGCTTTCGTCCGAGAAACCATATG|GTTGGGTTAAGGGCTGCAACTGCCTTTTCT
GGGCGGTGTTGCCTTTGTGGAGAAATTGAC|TGCCGCTGAGCCAATTGATACAGTCTGATC
TACAAAACTCAGCGCTCATGTGAGGTGTCG|GCCACTCATGTAATACACGTTGGGTAAGGT
CTGAGCAGATAAAGCCGATAAAGCTCCCCA|TGATAATGTCCCTCTGAGTTCACCGAGTCA
GACAACGTCTTGCGCTAACCCGACGTTGAG|TAGTGAGCACCCGTTTCGTGTCTTGGACCG
GAAACCATATGTTATGATAATGTCATACAC|GTCTACTGTAGTAGCCGGGTTCGCCCAGCA
AGGTTCGGTCAGTTGGGACAACGTCTTGCG|TAGCATGCCCCTCGCTTAGTGAGCACCCGT
TAATGTCCAGGGCGGTGTTGCCTTTGTGGA|CCACCTTGGTGCCGCTGAGCCAATTGATAC
GTGTAGCCACCCACAAAGGTGTCCGGTCCG|TTTACAAAACTCAGCGCTCATGTGAGGTGT
GGTCCGAGAAACCATATGTTATGATAATGT|AAACCATATGTTATGATAATGTCCAGGGCG
GATAATGTCTAAAGACGATGTCAAATGGAC|TTCGGTCAGTTGGGACAACGTCTTGCGCTA
CTTCTCATAGTCCCTCCACCAATAACGAGT|AAAGCTCCCCAAGGGAATGTCAGTGCTTTA
TGTTATGATAATGTCCAGGGCGGTGTTGCC|GCGTCTGTCCACCTTGGTGCCGCTGAGCCA
ACGCTTATATTCGCGGGTCATGTGGGGGTC|GAAACCATATGTTATGATAATGTCGAATAA
TCCGCCACTCATGTAATACACGTTGGGTAA|TGCCTTTGTGGAGAAATTGACTGTGTATTT
AGAAACCATATGTTATGATAATGTCAGAAA|CGCTCAAAAGACTCACAAAGGTAGGGATAC
GCTCACCGTCACCTATCATTTACAAAACTC|GTTATGATAATGTCTTATCCGCCACTCATG
GAGGGCAAATAGCTCTGGGGTACTCGGTTT|CATATGTTATGATAATGTCGGCTACGCATT
GTTATGATAATGTCGCTACAAAGACCAATA|CCGAGAGTCCGAGAAACCATATGTTATGAT
CAGGGTCCGAGAAACCATATGTTATGATAA|GAGAAACCATATGTTATGATAATGTCCAGG
TCACAAAGGTAGGGATACGCTTATATTCGC|AGTCGCTTTCGTCCGAGAAACCATATGTTA
AAGACCAATACCTTCACAGACGGTCCGAGA|ATGTTATGATAATGTCAACCATATGTTATG
CAAACCGCGGTCCGAGAAACCATATGTTAT|CTAAACATTTAAATGTGCTTATATCAGGGT
ATGAGCGGATAGAACCGATTGCGTAGTCCG|CCGCGGTCCGAGAAACCATATGTTATGATA
CAGGGTCCCTGAGCAGATAAAGCCGATAAA|ATATGTTATGATAATGTCCCTCTGAGTTCA
TTATGATAATGTCTAAAGACGATGTCAAAT|AAGGTTCGGTCAGTTGGGACAACGTCTTGC
GCACTGGTAGGGGTCCGAGAAACCATATGT|CATGAGCGGATAGAACCGATTGCGTAGTCC
ACACCATGCACTGGTAGGGGTCCGAGAAAC|AGCAATGCATGAGCGGATAGAACCGATTGC
TACCTTCACAGACGGTCCGAGAAACCATAT|ATAATGTCAACCATATGTTATGATAATGTC
GTTATGATAATGTCGAATAAGTCCGAGAAA|TCGCGCGGACACCCCCGGTCTCATATGGCG
CATGTAGGAATCCATGTGATTGACTCCGTC|GTCCGAGAAACCATATGTTATGATAATGTC
AAGGTGTCCGGTCCGAGAAACCATATGTTA|GCTCATGTGAGGTGTCGCTCAAAAGACTCA
GCTCTGGGGTACTCGGTTTGGAATAGCATG|ATAATGTCGGCTACGCATTGTTCCCTCTTA
CAAAAGACTCACAAAGGTAGGGATACGCTT|CCTCTCCGAGTCGCTTTCGTCCGAGAAACC
CCGAGAAACCATATGTTATGATAATGTCTT|CCATATGTTATGATAATGTCCAGGGCGGTG
ATGTCAAATGGACCTAAACATTTAAATGTG|ACGTCTTGCGCTAACCCGACGTTGAGTCCG
CGCCCAGCAATGCATGAGCGGATAGAACCG|TTTTACGAACAAACCGCGGTCCGAGAAACC
GAGTCCGAGAAACCATATGTTATGATAATG|TTTACTCAGCCTGACCCGCAAGGTTCGGTC
CCATATGTTATGATAATGTCATACACCATG|ACTGTAGTAGCCGGGTTCGCCCAGCAATGC
TTGTCGTGGTCCGAGAAACCATATGTTATG|TATGTTATGATAATGTCTACTGTAGTAGCC
TTTGTCCGCAGCAGAGTTCTCAATTTGTCG|CTTCACAGACGGTCCGAGAAACCATATGTT
GACAGGGTCCGAGAAACCATATGTTATGAT|CCGAGAAACCATATGTTATGATAATGTCCA
GATAATGTCTTCAACCCTGGGCTTCTCATA|CCCTGAGCAGATAAAGCCGATAAAGCTCCC
AACCATATGTTATGATAATGTCAGAAACCA|TCAAAAGACTCACAAAGGTAGGGATACGCT
GATAATGTCGAATAAGTCCGAGAAACCATA|CGGACACCCCCGGTCTCATATGGCGCCAAT
TCCCCAAGGGAATGTCAGTGCTTTACTCAG|GAGTCAGGAGGGCAAATAGCTCTGGGGTAC
AACCATATGTTATGATAATGTCCTGACCGA|CACCAATAACGAGTCCGAGAAACCATATGT
GAGAAACCATATGTTATGATAATGTCGGCT|GAAACCATATGTTATGATAATGTCCCGAGA
GAACGGTTTTTACGAACAAACCGCGGTCCG|ACGATGTCAAATGGACCTAAACATTTAAAT
GAAACCATATGTTATGATAATGTCTTATCC|ATGTTATGATAATGTCCAGGGCGGTGTTGC
GTCCAGGGCGGTGTTGCCTTTGTGGAGAAA|CTTGGTGCCGCTGAGCCAATTGATACAGTC
AGGGGTCCGAGAAACCATATGTTATGATAA|GATAGAACCGATTGCGTAGTCCGAGAGTCC
GATAATGTCATACACCATGCACTGGTAGGG|CGGGTTCGCCCAGCAATGCATGAGCGGATA
AAAGGTAGGGATACGCTTATATTCGCGGGT|GCTTTCGTCCGAGAAACCATATGTTATGAT
CGGTCCGAGAAACCATATGTTATGATAATG|GAGGTGTCGCTCAAAAGACTCACAAAGGTA
TTATGATAATGTCGCTACAAAGACCAATAC|CGAGAGTCCGAGAAACCATATGTTATGATA
GTGTCTTGGACCGAGATTGGCCGAACATGT|GTGTAGCCACCCACAAAGGTGTCCGGTCCG
TCTACTGTAGTAGCCGGGTTCGCCCAGCAA|AGACTGCAACGTAGAACGGTTTTTACGAAC
CCCTGGGCTTCTCATAGTCCCTCCACCAAT|AGCCGATAAAGCTCCCCAAGGGAATGTCAG
GTAGTAGCCGGGTTCGCCCAGCAATGCATG|CAACGTAGAACGGTTTTTACGAACAAACCG
TATGTTATGATAATGTCGGCTACGCATTGT|TGTTATGATAATGTCCCGAGAAACCATATG
GAGAAACCATATGTTATGATAATGTCTTCA|TGTGCTTATATCAGGGTCCCTGAGCAGATA
CGGGTCATGTGGGGGTCTAGACAGGGTCCG|ATGATAATGTCGAATAAGTCCGAGAAACCA
CTCACCGTCACCTATCATTTACAAAACTCA|TTATGATAATGTCTTATCCGCCACTCATGT
ACGTAGAACGGTTTTTACGAACAAACCGCG|TAAAGACGATGTCAAATGGACCTAAACATT
AAACCGCGGTCCGAGAAACCATATGTTATG|TAAACATTTAAATGTGCTTATATCAGGGTC
AGGTAGGGATACGCTTATATTCGCGGGTCA|TTTCGTCCGAGAAACCATATGTTATGATAA
CCGAGAAACCATATGTTATGATAATGTCAG|TGTCGCTCAAAAGACTCACAAAGGTAGGGA
ATAGTCCCTCCACCAATAACGAGTCCGAGA|CCCCAAGGGAATGTCAGTGCTTTACTCAGC
TAAAGCTCCCCAAGGGAATGTCAGTGCTTT|TTCACCGAGTCAGGAGGGCAAATAGCTCTG
CTACTGTAGTAGCCGGGTTCGCCCAGCAAT|GACTGCAACGTAGAACGGTTTTTACGAACA
TTACGAACAAACCGCGGTCCGAGAAACCAT|AATGGACCTAAACATTTAAATGTGCTTATA
ATACACCATGCACTGGTAGGGGTCCGAGAA|CCAGCAATGCATGAGCGGATAGAACCGATT
GATCCGGATGTGTAGCCACCCACAAAGGTG|CACCTATCATTTACAAAACTCAGCGCTCAT
CCTCCCGATCCGGATGTGTAGCCACCCACA|CACCGTCACCTATCATTTACAAAACTCAGC
ACCGAGATTGGCCGAACATGTAGGAATCCA|CCCACAAAGGTGTCCGGTCCGAGAAACCAT
CTCGGTTTGGAATAGCATGCCCCTCGCTTA|TACGCATTGTTCCCTCTTATGTATGATGTC
TTTCGTGTCTTGGACCGAGATTGGCCGAAC|GGATGTGTAGCCACCCACAAAGGTGTCCGG
ACAAAACTCAGCGCTCATGTGAGGTGTCGC|CCACTCATGTAATACACGTTGGGTAAGGTT
CAGCAATGCATGAGCGGATAGAACCGATTG|ACGAACAAACCGCGGTCCGAGAAACCATAT
GAATAAGTCCGAGAAACCATATGTTATGAT|CCGGTCTCATATGGCGCCAATGCGTCTGTC
CACCGTCACCTATCATTTACAAAACTCAGC|ATGATAATGTCTTATCCGCCACTCATGTAA
TCCGCAGCAGAGTTCTCAATTTGTCGTGGT|ACAGACGGTCCGAGAAACCATATGTTATGA
TTGTGGGCTGCGGTGTCACATATTTGTCCG|ATGTCGCTACAAAGACCAATACCTTCACAG
AAATGGACCTAAACATTTAAATGTGCTTAT|TTGCGCTAACCCGACGTTGAGTCCGAGAAA
AGGAGGGCAAATAGCTCTGGGGTACTCGGT|ACCATATGTTATGATAATGTCGGCTACGCA
TCTCCGAGTCGCTTTCGTCCGAGAAACCAT|ATTGTTGGGTTAAGGGCTGCAACTGCCTTT
ATTTAAATGTGCTTATATCAGGGTCCCTGA|CGTTGAGTCCGAGAAACCATATGTTATGAT
CCGTCACCTATCATTTACAAAACTCAGCGC|GATAATGTCTTATCCGCCACTCATGTAATA
AACCATATGTTATGATAATGTCAACCATAT|CCTGGGCTTCTCATAGTCCCTCCACCAATA
TCGGTTTGGAATAGCATGCCCCTCGCTTAG|ACGCATTGTTCCCTCTTATGTATGATGTCC
CAGGGCGGTGTTGCCTTTGTGGAGAAATTG|GGTGCCGCTGAGCCAATTGATACAGTCTGA
AAGCCGATAAAGCTCCCCAAGGGAATGTCA|CTCTGAGTTCACCGAGTCAGGAGGGCAAAT
CATGTGAGGTGTCGCTCAAAAGACTCACAA|ACGTTGGGTAAGGTTCCCTCTCCGAGTCGC
ATGCATGAGCGGATAGAACCGATTGCGTAG|CAAACCGCGGTCCGAGAAACCATATGTTAT
ATAATGTCCCGAGAAACCATATGTTATGAT|GGGTCATGTGGGGGTCTAGACAGGGTCCGA
TATGATAATGTCTAAAGACGATGTCAAATG|AGGTTCGGTCAGTTGGGACAACGTCTTGCG
CGAGAAACCATATGTTATGATAATGTCCAG|TATGGCGCCAATGCGTCTGTCCACCTTGGT
CGAGTCGCTTTCGTCCGAGAAACCATATGT|TTGGGTTAAGGGCTGCAACTGCCTTTTCTC
AAACCATATGTTATGATAATGTCAGAAACC|CTCAAAAGACTCACAAAGGTAGGGATACGC
TCAACCATATGTTATGATAATGTCCTGACC|TCCACCAATAACGAGTCCGAGAAACCATAT
GCGCTCATGTGAGGTGTCGCTCAAAAGACT|AATACACGTTGGGTAAGGTTCCCTCTCCGA
CCCGATCCGGATGTGTAGCCACCCACAAAG|CGTCACCTATCATTTACAAAACTCAGCGCT
TCACCGAGTCAGGAGGGCAAATAGCTCTGG|CGTCCGAGAAACCATATGTTATGATAATGT
CCTCCACCAATAACGAGTCCGAGAAACCAT|GGGAATGTCAGTGCTTTACTCAGCCTGACC
AGACCAATACCTTCACAGACGGTCCGAGAA|TGTTATGATAATGTCAACCATATGTTATGA
GGTCAGTTGGGACAACGTCTTGCGCTAACC|GCCCCTCGCTTAGTGAGCACCCGTTTCGTG
TAATGTCCTGACCGATACGAGACTGCAACG|CGAGAAACCATATGTTATGATAATGTCTAA
CAATTTGTCGTGGTCCGAGAAACCATATGT|ACCATATGTTATGATAATGTCTACTGTAGT
TCTTGGACCGAGATTGGCCGAACATGTAGG|TAGCCACCCACAAAGGTGTCCGGTCCGAGA
TTATGTATGATGTCCCTCCCGATCCGGATG|TAATGTCTAGTGCTCACCGTCACCTATCAT
TCTTATGTATGATGTCCCTCCCGATCCGGA|GATAATGTCTAGTGCTCACCGTCACCTATC
TGGTAGGGGTCCGAGAAACCATATGTTATG|AGCGGATAGAACCGATTGCGTAGTCCGAGA
CCAAGGGAATGTCAGTGCTTTACTCAGCCT|TCAGGAGGGCAAATAGCTCTGGGGTACTCG
CTCAAAAGACTCACAAAGGTAGGGATACGC|TCCCTCTCCGAGTCGCTTTCGTCCGAGAAA
ACAAAGACCAATACCTTCACAGACGGTCCG|CATATGTTATGATAATGTCAACCATATGTT
ATGTTATGATAATGTCTACTGTAGTAGCCG|TCCTGACCGATACGAGACTGCAACGTAGAA
AACCATATGTTATGATAATGTCGCTACAAA|TGCGTAGTCCGAGAGTCCGAGAAACCATAT
CACTCATGTAATACACGTTGGGTAAGGTTC|TTGTGGAGAAATTGACTGTGTATTTTATTA
GGTAGGGATACGCTTATATTCGCGGGTCAT|TTCGTCCGAGAAACCATATGTTATGATAAT
CGCAAGGTTCGGTCAGTTGGGACAACGTCT|GGAATAGCATGCCCCTCGCTTAGTGAGCAC
ATATGTTATGATAATGTCATACACCATGCA|TGTAGTAGCCGGGTTCGCCCAGCAATGCAT
AATGTCAGTGCTTTACTCAGCCTGACCCGC|GGCAAATAGCTCTGGGGTACTCGGTTTGGA
GTCATGTGGGGGTCTAGACAGGGTCCGAGA|ATAATGTCGAATAAGTCCGAGAAACCATAT
AGTTCACCGAGTCAGGAGGGCAAATAGCTC|CTCCGTCCGAGAAACCATATGTTATGATAA
GATAATGTCGCTACAAAGACCAATACCTTC|AGTCCGAGAAACCATATGTTATGATAATGT
AGTGAGCACCCGTTTCGTGTCTTGGACCGA|CCCTCCCGATCCGGATGTGTAGCCACCCAC
TCCGAGAAACCATATGTTATGATAATGTCT|ACCATATGTTATGATAATGTCCAGGGCGGT
TGGTCCGAGAAACCATATGTTATGATAATG|ATGATAATGTCTACTGTAGTAGCCGGGTTC
TGTTATGATAATGTCATACACCATGCACTG|AGTAGCCGGGTTCGCCCAGCAATGCATGAG
TTTAAATGTGCTTATATCAGGGTCCCTGAG|GTTGAGTCCGAGAAACCATATGTTATGATA
ATACACGTTGGGTAAGGTTCCCTCTCCGAG|ATTGACTGTGTATTTTATTATGATTGTTGG
ACACGTTGGGTAAGGTTCCCTCTCCGAGTC|TGACTGTGTATTTTATTATGATTGTTGGGT
GTTATGATAATGTCTAAAGACGATGTCAAA|CAAGGTTCGGTCAGTTGGGACAACGTCTTG
TCCGAGAAACCATATGTTATGATAATGTCT|TGTTATGATAATGTCCTGACCGATACGAGA
ACAAAGGTAGGGATACGCTTATATTCGCGG|TCGCTTTCGTCCGAGAAACCATATGTTATG
TATATCAGGGTCCCTGAGCAGATAAAGCCG|AAACCATATGTTATGATAATGTCCCTCTGA
GGTCTAGACAGGGTCCGAGAAACCATATGT|ATAAGTCCGAGAAACCATATGTTATGATAA
ATATGTTATGATAATGTCAGAAACCATATG|AAGACTCACAAAGGTAGGGATACGCTTATA
CATTTTGTGGGCTGCGGTGTCACATATTTG|GATAATGTCGCTACAAAGACCAATACCTTC
GAATAGCATGCCCCTCGCTTAGTGAGCACC|TTCCCTCTTATGTATGATGTCCCTCCCGAT
CCATATGTTATGATAATGTCCTGACCGATA|CCAATAACGAGTCCGAGAAACCATATGTTA
AGCCTGACCCGCAAGGTTCGGTCAGTTGGG|ACTCGGTTTGGAATAGCATGCCCCTCGCTT
CTGAGTTCACCGAGTCAGGAGGGCAAATAG|TGACTCCGTCCGAGAAACCATATGTTATGA
CTAGTGCTCACCGTCACCTATCATTTACAA|CATATGTTATGATAATGTCTTATCCGCCAC
ACCGAGTCAGGAGGGCAAATAGCTCTGGGG|TCCGAGAAACCATATGTTATGATAATGTCG
CCATATGTTATGATAATGTCTAGTGCTCAC|TAGACAGGGTCCGAGAAACCATATGTTATG
TTTACGAACAAACCGCGGTCCGAGAAACCA|AAATGGACCTAAACATTTAAATGTGCTTAT
TATGATAATGTCAGAAACCATATGTTATGA|CACAAAGGTAGGGATACGCTTATATTCGCG
TGATAATGTCAACCATATGTTATGATAATG|ATAGTCCCTCCACCAATAACGAGTCCGAGA
GAGTCAGGAGGGCAAATAGCTCTGGGGTAC|GAGAAACCATATGTTATGATAATGTCGGCT
CGAGAAACCATATGTTATGATAATGTCGCT|CCGATTGCGTAGTCCGAGAGTCCGAGAAAC
GTCCTGACCGATACGAGACTGCAACGTAGA|AAACCATATGTTATGATAATGTCTAAAGAC
CTGGGCTTCTCATAGTCCCTCCACCAATAA|CCGATAAAGCTCCCCAAGGGAATGTCAGTG
TAGGGGTCCGAGAAACCATATGTTATGATA|GGATAGAACCGATTGCGTAGTCCGAGAGTC
ATGATAATGTCCTGACCGATACGAGACTGC|AGTCCGAGAAACCATATGTTATGATAATGT
GAGTCCGAGAAACCATATGTTATGATAATG|TGTCTTCAACCCTGGGCTTCTCATAGTCCC
TAAATGTGCTTATATCAGGGTCCCTGAGCA|TGAGTCCGAGAAACCATATGTTATGATAAT
AGTCGCTTTCGTCCGAGAAACCATATGTTA|GGGTTAAGGGCTGCAACTGCCTTTTCTCGC
GCCGGGTTCGCCCAGCAATGCATGAGCGGA|AGAACGGTTTTTACGAACAAACCGCGGTCC
CGGTTTTTACGAACAAACCGCGGTCCGAGA|ATGTCAAATGGACCTAAACATTTAAATGTG
CGAGAAACCATATGTTATGATAATGTCTTC|ATGTGCTTATATCAGGGTCCCTGAGCAGAT
CACCGAGTCAGGAGGGCAAATAGCTCTGGG|GTCCGAGAAACCATATGTTATGATAATGTC
ACATATTTGTCCGCAGCAGAGTTCTCAATT|AATACCTTCACAGACGGTCCGAGAAACCAT
TATGTATGATGTCCCTCCCGATCCGGATGT|AATGTCTAGTGCTCACCGTCACCTATCATT
GTGGAGAAATTGACTGTGTATTTTATTATG|GATACAGTCTGATCAGGTCAAATGGCTTGA
GTAGGAATCCATGTGATTGACTCCGTCCGA|CGAGAAACCATATGTTATGATAATGTCAGA
TGGGACAACGTCTTGCGCTAACCCGACGTT|GCTTAGTGAGCACCCGTTTCGTGTCTTGGA
ATGATAATGTCAACCATATGTTATGATAAT|CATAGTCCCTCCACCAATAACGAGTCCGAG
TGTGTAGCCACCCACAAAGGTGTCCGGTCC|ATTTACAAAACTCAGCGCTCATGTGAGGTG
AACCATATGTTATGATAATGTCATACACCA|CTACTGTAGTAGCCGGGTTCGCCCAGCAAT
CACCCGTTTCGTGTCTTGGACCGAGATTGG|CGATCCGGATGTGTAGCCACCCACAAAGGT
GCCACTCATGTAATACACGTTGGGTAAGGT|CTTTGTGGAGAAATTGACTGTGTATTTTAT
CCATATGTTATGATAATGTCTTCAACCCTG|TATATCAGGGTCCCTGAGCAGATAAAGCCG
ATAATGTCGAATAAGTCCGAGAAACCATAT|GGACACCCCCGGTCTCATATGGCGCCAATG
AAAGACGATGTCAAATGGACCTAAACATTT|TGGGACAACGTCTTGCGCTAACCCGACGTT
CAGTGCTTTACTCAGCCTGACCCGCAAGGT|ATAGCTCTGGGGTACTCGGTTTGGAATAGC
GTCCCTCCACCAATAACGAGTCCGAGAAAC|CAAGGGAATGTCAGTGCTTTACTCAGCCTG
CGGGTTCGCCCAGCAATGCATGAGCGGATA|AACGGTTTTTACGAACAAACCGCGGTCCGA
GGGCTGCGGTGTCACATATTTGTCCGCAGC|CGCTACAAAGACCAATACCTTCACAGACGG
GACCCGCAAGGTTCGGTCAGTTGGGACAAC|GTTTGGAATAGCATGCCCCTCGCTTAGTGA
TATGATAATGTCAACCATATGTTATGATAA|TCATAGTCCCTCCACCAATAACGAGTCCGA
CAGTTGGGACAACGTCTTGCGCTAACCCGA|CCTCGCTTAGTGAGCACCCGTTTCGTGTCT
GGAATAGCATGCCCCTCGCTTAGTGAGCAC|GTTCCCTCTTATGTATGATGTCCCTCCCGA
TCGGCTACGCATTGTTCCCTCTTATGTATG|CCGAGAAACCATATGTTATGATAATGTCTA
CTGCAACGTAGAACGGTTTTTACGAACAAA|ATGTCTAAAGACGATGTCAAATGGACCTAA
GTCCGAGAAACCATATGTTATGATAATGTC|TACTCAGCCTGACCCGCAAGGTTCGGTCAG
AGCGCTCATGTGAGGTGTCGCTCAAAAGAC|TAATACACGTTGGGTAAGGTTCCCTCTCCG
CGAGAAACCATATGTTATGATAATGTCGGC|AGAAACCATATGTTATGATAATGTCCCGAG
GGATGTGTAGCCACCCACAAAGGTGTCCGG|ATCATTTACAAAACTCAGCGCTCATGTGAG
TGTTATGATAATGTCCTGACCGATACGAGA|AACGAGTCCGAGAAACCATATGTTATGATA
GTTGAGTCCGAGAAACCATATGTTATGATA|GGACCGAGATTGGCCGAACATGTAGGAATC
CGCAGCAGAGTTCTCAATTTGTCGTGGTCC|AGACGGTCCGAGAAACCATATGTTATGATA
AGACTCACAAAGGTAGGGATACGCTTATAT|TCCGAGTCGCTTTCGTCCGAGAAACCATAT
ACTGTGTATTTTATTATGATTGTTGGGTTA|TCAGGTCAAATGGCTTGAGGCGGTGCGCGG
ATAATGTCCAGGGCGGTGTTGCCTTTGTGG|TCCACCTTGGTGCCGCTGAGCCAATTGATA
CCGACGTTGAGTCCGAGAAACCATATGTTA|GTCTTGGACCGAGATTGGCCGAACATGTAG
ACCATATGTTATGATAATGTCCTGACCGAT|ACCAATAACGAGTCCGAGAAACCATATGTT
CCCCTCGCTTAGTGAGCACCCGTTTCGTGT|TGTATGATGTCCCTCCCGATCCGGATGTGT
GTCTTGCGCTAACCCGACGTTGAGTCCGAG|GCACCCGTTTCGTGTCTTGGACCGAGATTG
GGACAACGTCTTGCGCTAACCCGACGTTGA|TTAGTGAGCACCCGTTTCGTGTCTTGGACC
CTCATAGTCCCTCCACCAATAACGAGTCCG|GCTCCCCAAGGGAATGTCAGTGCTTTACTC
GGGATACGCTTATATTCGCGGGTCATGTGG|TCCGAGAAACCATATGTTATGATAATGTCG
AGAAACCATATGTTATGATAATGTCGGCTA|AAACCATATGTTATGATAATGTCCCGAGAA
GTTATGATAATGTCAACCATATGTTATGAT|TCTCATAGTCCCTCCACCAATAACGAGTCC
CGGTTTGGAATAGCATGCCCCTCGCTTAGT|CGCATTGTTCCCTCTTATGTATGATGTCCC
TGTTATGATAATGTCAACCATATGTTATGA|TTCTCATAGTCCCTCCACCAATAACGAGTC
TCATGTGAGGTGTCGCTCAAAAGACTCACA|CACGTTGGGTAAGGTTCCCTCTCCGAGTCG
TGTCCGCAGCAGAGTTCTCAATTTGTCGTG|TCACAGACGGTCCGAGAAACCATATGTTAT
TATGATAATGTCTTCAACCCTGGGCTTCTC|GGTCCCTGAGCAGATAAAGCCGATAAAGCT
TCCCTCTTATGTATGATGTCCCTCCCGATC|TTATGATAATGTCTAGTGCTCACCGTCACC
GCGTAGTCCGAGAGTCCGAGAAACCATATG|TGTTATGATAATGTCTTCAACCCTGGGCTT
CCACTCATGTAATACACGTTGGGTAAGGTT|TTTGTGGAGAAATTGACTGTGTATTTTATT
GGCCGAACATGTAGGAATCCATGTGATTGA|GTGTCCGGTCCGAGAAACCATATGTTATGA
CGAACAAACCGCGGTCCGAGAAACCATATG|GGACCTAAACATTTAAATGTGCTTATATCA
ACCATATGTTATGATAATGTCTTATCCGCC|TTATGATAATGTCCAGGGCGGTGTTGCCTT
TCTAGTGCTCACCGTCACCTATCATTTACA|CCATATGTTATGATAATGTCTTATCCGCCA
AGAAACCATATGTTATGATAATGTCGCTAC|GATTGCGTAGTCCGAGAGTCCGAGAAACCA
CCCGAGAAACCATATGTTATGATAATGTCT|GTGGGGGTCTAGACAGGGTCCGAGAAACCA
ACTCATGTAATACACGTTGGGTAAGGTTCC|TGTGGAGAAATTGACTGTGTATTTTATTAT
GTTATGATAATGTCCCGAGAAACCATATGT|ATTCGCGGGTCATGTGGGGGTCTAGACAGG
GAGAAACCATATGTTATGATAATGTCCCTC|TTGGCCGAACATGTAGGAATCCATGTGATT
GGGTCCGAGAAACCATATGTTATGATAATG|GAAACCATATGTTATGATAATGTCCAGGGC
TTGGCCGAACATGTAGGAATCCATGTGATT|AGGTGTCCGGTCCGAGAAACCATATGTTAT
AGAAACCATATGTTATGATAATGTCAACCA|AACCCTGGGCTTCTCATAGTCCCTCCACCA
AAAGACCAATACCTTCACAGACGGTCCGAG|TATGTTATGATAATGTCAACCATATGTTAT
TTATGATAATGTCCAGGGCGGTGTTGCCTT|GTCTGTCCACCTTGGTGCCGCTGAGCCAAT
GTGTCCGGTCCGAGAAACCATATGTTATGA|CATGTGAGGTGTCGCTCAAAAGACTCACAA
CCATATGTTATGATAATGTCCCTCTGAGTT|GAACATGTAGGAATCCATGTGATTGACTCC
ATACGCTTATATTCGCGGGTCATGTGGGGG|GAGAAACCATATGTTATGATAATGTCGAAT
GAAACCATATGTTATGATAATGTCCCTCTG|GGCCGAACATGTAGGAATCCATGTGATTGA
CCAGGGCGGTGTTGCCTTTGTGGAGAAATT|TGGTGCCGCTGAGCCAATTGATACAGTCTG
AGAGTCCGAGAAACCATATGTTATGATAAT|ATGTCTTCAACCCTGGGCTTCTCATAGTCC
GTAAGGTTCCCTCTCCGAGTCGCTTTCGTC|ATTTTATTATGATTGTTGGGTTAAGGGCTG
CATATTTGTCCGCAGCAGAGTTCTCAATTT|ATACCTTCACAGACGGTCCGAGAAACCATA
GGCGGTGTTGCCTTTGTGGAGAAATTGACT|GCCGCTGAGCCAATTGATACAGTCTGATCA
TCCCTCCCGATCCGGATGTGTAGCCACCCA|CTCACCGTCACCTATCATTTACAAAACTCA
ACATGTAGGAATCCATGTGATTGACTCCGT|GGTCCGAGAAACCATATGTTATGATAATGT
ACCATATGTTATGATAATGTCAGAAACCAT|CAAAAGACTCACAAAGGTAGGGATACGCTT
AACCATATGTTATGATAATGTCCAGGGCGG|CGCCAATGCGTCTGTCCACCTTGGTGCCGC
AACCATATGTTATGATAATGTCCCGAGAAA|ACGCTTATATTCGCGGGTCATGTGGGGGTC
GAAACCATATGTTATGATAATGTCCCGAGA|ATACGCTTATATTCGCGGGTCATGTGGGGG
CCGTTTCGTGTCTTGGACCGAGATTGGCCG|TCCGGATGTGTAGCCACCCACAAAGGTGTC
CATATGTTATGATAATGTCTACTGTAGTAG|ATGTCCTGACCGATACGAGACTGCAACGTA
GAACCGATTGCGTAGTCCGAGAGTCCGAGA|GAAACCATATGTTATGATAATGTCTTCAAC
GTGTTGCCTTTGTGGAGAAATTGACTGTGT|CTGAGCCAATTGATACAGTCTGATCAGGTC
CCTCTCCGAGTCGCTTTCGTCCGAGAAACC|TGATTGTTGGGTTAAGGGCTGCAACTGCCT
TGTAGGAATCCATGTGATTGACTCCGTCCG|CCGAGAAACCATATGTTATGATAATGTCAG
CCAATACCTTCACAGACGGTCCGAGAAACC|TATGATAATGTCAACCATATGTTATGATAA
CGGCTACGCATTGTTCCCTCTTATGTATGA|CGAGAAACCATATGTTATGATAATGTCTAG
AGGGAATGTCAGTGCTTTACTCAGCCTGAC|GGAGGGCAAATAGCTCTGGGGTACTCGGTT
TAGACAGGGTCCGAGAAACCATATGTTATG|GTCCGAGAAACCATATGTTATGATAATGTC
CGCGGGTCATGTGGGGGTCTAGACAGGGTC|TTATGATAATGTCGAATAAGTCCGAGAAAC
GAAACCATATGTTATGATAATGTCCAGGGC|GGCGCCAATGCGTCTGTCCACCTTGGTGCC
TGTGCTTATATCAGGGTCCCTGAGCAGATA|TCCGAGAAACCATATGTTATGATAATGTCC
CGGTGTTGCCTTTGTGGAGAAATTGACTGT|CGCTGAGCCAATTGATACAGTCTGATCAGG
AAACCATATGTTATGATAATGTCTAAAGAC|CCTGACCCGCAAGGTTCGGTCAGTTGGGAC
GTGTCGCTCAAAAGACTCACAAAGGTAGGG|TAAGGTTCCCTCTCCGAGTCGCTTTCGTCC
GAAACCATATGTTATGATAATGTCGCTACA|ATTGCGTAGTCCGAGAGTCCGAGAAACCAT
CTCCACCAATAACGAGTCCGAGAAACCATA|GGAATGTCAGTGCTTTACTCAGCCTGACCC
CCGCAAGGTTCGGTCAGTTGGGACAACGTC|TGGAATAGCATGCCCCTCGCTTAGTGAGCA
TGTCCCTCTGAGTTCACCGAGTCAGGAGGG|ATGTGATTGACTCCGTCCGAGAAACCATAT
CAAAGGTGTCCGGTCCGAGAAACCATATGT|GCGCTCATGTGAGGTGTCGCTCAAAAGACT
CCACCCACAAAGGTGTCCGGTCCGAGAAAC|AAACTCAGCGCTCATGTGAGGTGTCGCTCA
TATCCGCCACTCATGTAATACACGTTGGGT|GTTGCCTTTGTGGAGAAATTGACTGTGTAT
GTCTAAAGACGATGTCAAATGGACCTAAAC|CAGTTGGGACAACGTCTTGCGCTAACCCGA
AAACCATATGTTATGATAATGTCTACTGTA|GATAATGTCCTGACCGATACGAGACTGCAA
TTCGGTCAGTTGGGACAACGTCTTGCGCTA|CATGCCCCTCGCTTAGTGAGCACCCGTTTC
GGGGTCTAGACAGGGTCCGAGAAACCATAT|GAATAAGTCCGAGAAACCATATGTTATGAT
CTTAGTGAGCACCCGTTTCGTGTCTTGGAC|TGTCCCTCCCGATCCGGATGTGTAGCCACC
CGACGTTGAGTCCGAGAAACCATATGTTAT|TCTTGGACCGAGATTGGCCGAACATGTAGG
CCCCAAGGGAATGTCAGTGCTTTACTCAGC|AGTCAGGAGGGCAAATAGCTCTGGGGTACT
CAAGGTTCGGTCAGTTGGGACAACGTCTTG|AATAGCATGCCCCTCGCTTAGTGAGCACCC
TCTTATCCGCCACTCATGTAATACACGTTG|GGTGTTGCCTTTGTGGAGAAATTGACTGTG
TGTCTAGTGCTCACCGTCACCTATCATTTA|AACCATATGTTATGATAATGTCTTATCCGC
TTCACAGACGGTCCGAGAAACCATATGTTA|TGTCAACCATATGTTATGATAATGTCCTGA
AATACCTTCACAGACGGTCCGAGAAACCAT|TGATAATGTCAACCATATGTTATGATAATG
ACCCGACGTTGAGTCCGAGAAACCATATGT|GTGTCTTGGACCGAGATTGGCCGAACATGT
AACCCTGGGCTTCTCATAGTCCCTCCACCA|AAAGCCGATAAAGCTCCCCAAGGGAATGTC
ACCGTCACCTATCATTTACAAAACTCAGCG|TGATAATGTCTTATCCGCCACTCATGTAAT
AAAGCTCCCCAAGGGAATGTCAGTGCTTTA|TCACCGAGTCAGGAGGGCAAATAGCTCTGG
AAGGTTCCCTCTCCGAGTCGCTTTCGTCCG|TTTATTATGATTGTTGGGTTAAGGGCTGCA
GTTATGATAATGTCCCTCTGAGTTCACCGA|GTAGGAATCCATGTGATTGACTCCGTCCGA
ATCCGCCACTCATGTAATACACGTTGGGTA|TTGCCTTTGTGGAGAAATTGACTGTGTATT
TGTTATGATAATGTCGAATAAGTCCGAGAA|CTCGCGCGGACACCCCCGGTCTCATATGGC
CCTCGCTTAGTGAGCACCCGTTTCGTGTCT|TATGATGTCCCTCCCGATCCGGATGTGTAG
TGGGGGTCTAGACAGGGTCCGAGAAACCAT|TCGAATAAGTCCGAGAAACCATATGTTATG
GAGAAACCATATGTTATGATAATGTCAGAA|TCGCTCAAAAGACTCACAAAGGTAGGGATA
TATGATGTCCCTCCCGATCCGGATGTGTAG|TCTAGTGCTCACCGTCACCTATCATTTACA
CTGTGTATTTTATTATGATTGTTGGGTTAA|CAGGTCAAATGGCTTGAGGCGGTGCGCGGC
CCGATTGCGTAGTCCGAGAGTCCGAGAAAC|ACCATATGTTATGATAATGTCTTCAACCCT
TAATGTCAACCATATGTTATGATAATGTCC|GTCCCTCCACCAATAACGAGTCCGAGAAAC
CAATGCATGAGCGGATAGAACCGATTGCGT|AACAAACCGCGGTCCGAGAAACCATATGTT
ATATGTTATGATAATGTCCTGACCGATACG|AATAACGAGTCCGAGAAACCATATGTTATG
ACAACGTCTTGCGCTAACCCGACGTTGAGT|AGTGAGCACCCGTTTCGTGTCTTGGACCGA
AAAAGACTCACAAAGGTAGGGATACGCTTA|CTCTCCGAGTCGCTTTCGTCCGAGAAACCA
TGTTATGATAATGTCTAAAGACGATGTCAA|GCAAGGTTCGGTCAGTTGGGACAACGTCTT
TCGTGGTCCGAGAAACCATATGTTATGATA|GTTATGATAATGTCTACTGTAGTAGCCGGG
CTCTCCGAGTCGCTTTCGTCCGAGAAACCA|GATTGTTGGGTTAAGGGCTGCAACTGCCTT
TGATAATGTCGCTACAAAGACCAATACCTT|GAGTCCGAGAAACCATATGTTATGATAATG
CCGAGAAACCATATGTTATGATAATGTCTA|TGGGGGTCTAGACAGGGTCCGAGAAACCAT
TCCCTCTGAGTTCACCGAGTCAGGAGGGCA|GTGATTGACTCCGTCCGAGAAACCATATGT
GCTCCCCAAGGGAATGTCAGTGCTTTACTC|CCGAGTCAGGAGGGCAAATAGCTCTGGGGT
AAATGTGCTTATATCAGGGTCCCTGAGCAG|GAGTCCGAGAAACCATATGTTATGATAATG
TAGCCACCCACAAAGGTGTCCGGTCCGAGA|ACAAAACTCAGCGCTCATGTGAGGTGTCGC
AATGGACCTAAACATTTAAATGTGCTTATA|TGCGCTAACCCGACGTTGAGTCCGAGAAAC
GTCCCGAGAAACCATATGTTATGATAATGT|ATGTGGGGGTCTAGACAGGGTCCGAGAAAC
GCGCTAACCCGACGTTGAGTCCGAGAAACC|CGTTTCGTGTCTTGGACCGAGATTGGCCGA
GGATACGCTTATATTCGCGGGTCATGTGGG|CCGAGAAACCATATGTTATGATAATGTCGA
ATGTCGCTACAAAGACCAATACCTTCACAG|CGAGAAACCATATGTTATGATAATGTCAAC
TTAAATGTGCTTATATCAGGGTCCCTGAGC|TTGAGTCCGAGAAACCATATGTTATGATAA
AGGGCAAATAGCTCTGGGGTACTCGGTTTG|ATATGTTATGATAATGTCGGCTACGCATTG
GCTTATATCAGGGTCCCTGAGCAGATAAAG|GAGAAACCATATGTTATGATAATGTCCCTC
AACCCGACGTTGAGTCCGAGAAACCATATG|CGTGTCTTGGACCGAGATTGGCCGAACATG
TATGTTATGATAATGTCCCTCTGAGTTCAC|CATGTAGGAATCCATGTGATTGACTCCGTC
TCAGAAACCATATGTTATGATAATGTCCCG|GGGATACGCTTATATTCGCGGGTCATGTGG
TATGATAATGTCTAGTGCTCACCGTCACCT|GTCCGAGAAACCATATGTTATGATAATGTC
TCCGAGAAACCATATGTTATGATAATGTCG|TGCAACTGCCTTTTCTCGCGCGGACACCCC
TCATGTGGGGGTCTAGACAGGGTCCGAGAA|TAATGTCGAATAAGTCCGAGAAACCATATG
TGTCCGGTCCGAGAAACCATATGTTATGAT|ATGTGAGGTGTCGCTCAAAAGACTCACAAA
GTTTTTACGAACAAACCGCGGTCCGAGAAA|GTCAAATGGACCTAAACATTTAAATGTGCT
AGTTCTCAATTTGTCGTGGTCCGAGAAACC|CGAGAAACCATATGTTATGATAATGTCTAC
ATGATAATGTCGCTACAAAGACCAATACCT|AGAGTCCGAGAAACCATATGTTATGATAAT
TTACTCAGCCTGACCCGCAAGGTTCGGTCA|TGGGGTACTCGGTTTGGAATAGCATGCCCC
CCGATACGAGACTGCAACGTAGAACGGTTT|ATGTTATGATAATGTCTAAAGACGATGTCA
TGACCCGCAAGGTTCGGTCAGTTGGGACAA|GGTTTGGAATAGCATGCCCCTCGCTTAGTG
GGGACAACGTCTTGCGCTAACCCGACGTTG|CTTAGTGAGCACCCGTTTCGTGTCTTGGAC
TCACCGTCACCTATCATTTACAAAACTCAG|TATGATAATGTCTTATCCGCCACTCATGTA
TCCGGTCCGAGAAACCATATGTTATGATAA|GTGAGGTGTCGCTCAAAAGACTCACAAAGG
CACCATGCACTGGTAGGGGTCCGAGAAACC|GCAATGCATGAGCGGATAGAACCGATTGCG
TCCGAGAAACCATATGTTATGATAATGTCA|GTGTCGCTCAAAAGACTCACAAAGGTAGGG
TTGACTGTGTATTTTATTATGATTGTTGGG|TGATCAGGTCAAATGGCTTGAGGCGGTGCG
TAGAACGGTTTTTACGAACAAACCGCGGTC|AGACGATGTCAAATGGACCTAAACATTTAA
CAACCCTGGGCTTCTCATAGTCCCTCCACC|TAAAGCCGATAAAGCTCCCCAAGGGAATGT
CAAAGGTAGGGATACGCTTATATTCGCGGG|CGCTTTCGTCCGAGAAACCATATGTTATGA
TTCCCTCTCCGAGTCGCTTTCGTCCGAGAA|TTATGATTGTTGGGTTAAGGGCTGCAACTG
CTTTACTCAGCCTGACCCGCAAGGTTCGGT|TCTGGGGTACTCGGTTTGGAATAGCATGCC
TATGTTATGATAATGTCTTCAACCCTGGGC|ATCAGGGTCCCTGAGCAGATAAAGCCGATA
TTTTTACGAACAAACCGCGGTCCGAGAAAC|TCAAATGGACCTAAACATTTAAATGTGCTT
TGCTTATATCAGGGTCCCTGAGCAGATAAA|CGAGAAACCATATGTTATGATAATGTCCCT
GTCGCTTTCGTCCGAGAAACCATATGTTAT|GGTTAAGGGCTGCAACTGCCTTTTCTCGCG
AAGCTCCCCAAGGGAATGTCAGTGCTTTAC|CACCGAGTCAGGAGGGCAAATAGCTCTGGG
ATGTTATGATAATGTCCAGGGCGGTGTTGC|TGCGTCTGTCCACCTTGGTGCCGCTGAGCC
TATGTTATGATAATGTCTTATCCGCCACTC|GATAATGTCCAGGGCGGTGTTGCCTTTGTG
TATGTTATGATAATGTCGAATAAGTCCGAG|TTCTCGCGCGGACACCCCCGGTCTCATATG
TGTCCCGAGAAACCATATGTTATGATAATG|CATGTGGGGGTCTAGACAGGGTCCGAGAAA
AAATAGCTCTGGGGTACTCGGTTTGGAATA|TTATGATAATGTCGGCTACGCATTGTTCCC
CCGAGTCAGGAGGGCAAATAGCTCTGGGGT|CCGAGAAACCATATGTTATGATAATGTCGG
CGGTGTCACATATTTGTCCGCAGCAGAGTT|AAAGACCAATACCTTCACAGACGGTCCGAG
TAGTAGCCGGGTTCGCCCAGCAATGCATGA|AACGTAGAACGGTTTTTACGAACAAACCGC
GTAGCCACCCACAAAGGTGTCCGGTCCGAG|TACAAAACTCAGCGCTCATGTGAGGTGTCG
GCTCAAAAGACTCACAAAGGTAGGGATACG|TTCCCTCTCCGAGTCGCTTTCGTCCGAGAA
AAACCATATGTTATGATAATGTCTTCAACC|GCTTATATCAGGGTCCCTGAGCAGATAAAG
GTCCGAGAAACCATATGTTATGATAATGTC|GTCAGAAACCATATGTTATGATAATGTCCC
CAACGTCTTGCGCTAACCCGACGTTGAGTC|GTGAGCACCCGTTTCGTGTCTTGGACCGAG
ACCATATGTTATGATAATGTCCCTCTGAGT|CGAACATGTAGGAATCCATGTGATTGACTC
CCCGACGTTGAGTCCGAGAAACCATATGTT|TGTCTTGGACCGAGATTGGCCGAACATGTA
GTGCTTTACTCAGCCTGACCCGCAAGGTTC|AGCTCTGGGGTACTCGGTTTGGAATAGCAT
AACGTCTTGCGCTAACCCGACGTTGAGTCC|TGAGCACCCGTTTCGTGTCTTGGACCGAGA
GTCCGAGAAACCATATGTTATGATAATGTC|GGTGTCGCTCAAAAGACTCACAAAGGTAGG
TATGATAATGTCGAATAAGTCCGAGAAACC|GCGCGGACACCCCCGGTCTCATATGGCGCC
ATATGTTATGATAATGTCTAGTGCTCACCG|GACAGGGTCCGAGAAACCATATGTTATGAT
CCGCAGCAGAGTTCTCAATTTGTCGTGGTC|CAGACGGTCCGAGAAACCATATGTTATGAT
AAAACTCAGCGCTCATGTGAGGTGTCGCTC|ACTCATGTAATACACGTTGGGTAAGGTTCC
TTAGTGAGCACCCGTTTCGTGTCTTGGACC|GTCCCTCCCGATCCGGATGTGTAGCCACCC
CACTGGTAGGGGTCCGAGAAACCATATGTT|ATGAGCGGATAGAACCGATTGCGTAGTCCG
TATGTTATGATAATGTCCCGAGAAACCATA|TATATTCGCGGGTCATGTGGGGGTCTAGAC
TTCGTGTCTTGGACCGAGATTGGCCGAACA|GATGTGTAGCCACCCACAAAGGTGTCCGGT
CCGAGAAACCATATGTTATGATAATGTCCC|GATTGGCCGAACATGTAGGAATCCATGTGA
GGTCCCTGAGCAGATAAAGCCGATAAAGCT|TGTTATGATAATGTCCCTCTGAGTTCACCG
ATGTTATGATAATGTCATACACCATGCACT|TAGTAGCCGGGTTCGCCCAGCAATGCATGA
TCGTCCGAGAAACCATATGTTATGATAATG|GGCTGCAACTGCCTTTTCTCGCGCGGACAC
ATTTTGTGGGCTGCGGTGTCACATATTTGT|ATAATGTCGCTACAAAGACCAATACCTTCA
CAGGAGGGCAAATAGCTCTGGGGTACTCGG|AACCATATGTTATGATAATGTCGGCTACGC
GGAGGGCAAATAGCTCTGGGGTACTCGGTT|CCATATGTTATGATAATGTCGGCTACGCAT
TAAACATTTAAATGTGCTTATATCAGGGTC|CCCGACGTTGAGTCCGAGAAACCATATGTT
TCCCGATCCGGATGTGTAGCCACCCACAAA|CCGTCACCTATCATTTACAAAACTCAGCGC
GTCTTCAACCCTGGGCTTCTCATAGTCCCT|GCAGATAAAGCCGATAAAGCTCCCCAAGGG
CTTTGTGGAGAAATTGACTGTGTATTTTAT|AATTGATACAGTCTGATCAGGTCAAATGGC
TTATGATAATGTCTACTGTAGTAGCCGGGT|TGACCGATACGAGACTGCAACGTAGAACGG
AGAAACCATATGTTATGATAATGTCTAGTG|GGGTCTAGACAGGGTCCGAGAAACCATATG
TCCATGTGATTGACTCCGTCCGAGAAACCA|CCATATGTTATGATAATGTCAGAAACCATA
GTCGTGGTCCGAGAAACCATATGTTATGAT|TGTTATGATAATGTCTACTGTAGTAGCCGG
CCGTCCGAGAAACCATATGTTATGATAATG|ATGTCAGAAACCATATGTTATGATAATGTC
CCATATGTTATGATAATGTCTAAAGACGAT|GACCCGCAAGGTTCGGTCAGTTGGGACAAC
GTCTAGTGCTCACCGTCACCTATCATTTAC|ACCATATGTTATGATAATGTCTTATCCGCC
AATGTCAGAAACCATATGTTATGATAATGT|GGTAGGGATACGCTTATATTCGCGGGTCAT
CGAGAAACCATATGTTATGATAATGTCTAG|GGGGGTCTAGACAGGGTCCGAGAAACCATA
TCGAATAAGTCCGAGAAACCATATGTTATG|CCCCGGTCTCATATGGCGCCAATGCGTCTG
AGAAACCATATGTTATGATAATGTCTTATC|TATGTTATGATAATGTCCAGGGCGGTGTTG
AGGTGTCCGGTCCGAGAAACCATATGTTAT|CTCATGTGAGGTGTCGCTCAAAAGACTCAC
TGGACCGAGATTGGCCGAACATGTAGGAAT|CCACCCACAAAGGTGTCCGGTCCGAGAAAC
GATAAAGCTCCCCAAGGGAATGTCAGTGCT|AGTTCACCGAGTCAGGAGGGCAAATAGCTC
CATAGTCCCTCCACCAATAACGAGTCCGAG|TCCCCAAGGGAATGTCAGTGCTTTACTCAG
GTTGGGTAAGGTTCCCTCTCCGAGTCGCTT|TGTGTATTTTATTATGATTGTTGGGTTAAG
CGAGATTGGCCGAACATGTAGGAATCCATG|CACAAAGGTGTCCGGTCCGAGAAACCATAT
CCTGACCGATACGAGACTGCAACGTAGAAC|ACCATATGTTATGATAATGTCTAAAGACGA
TCAGGGTCCCTGAGCAGATAAAGCCGATAA|CATATGTTATGATAATGTCCCTCTGAGTTC
AGACAGGGTCCGAGAAACCATATGTTATGA|TCCGAGAAACCATATGTTATGATAATGTCC
CCTTCACAGACGGTCCGAGAAACCATATGT|AATGTCAACCATATGTTATGATAATGTCCT
AGGGATACGCTTATATTCGCGGGTCATGTG|GTCCGAGAAACCATATGTTATGATAATGTC
TCAGGAGGGCAAATAGCTCTGGGGTACTCG|AAACCATATGTTATGATAATGTCGGCTACG
AGCAGATAAAGCCGATAAAGCTCCCCAAGG|TAATGTCCCTCTGAGTTCACCGAGTCAGGA
TCGCGGGTCATGTGGGGGTCTAGACAGGGT|GTTATGATAATGTCGAATAAGTCCGAGAAA
ATATGTTATGATAATGTCGAATAAGTCCGA|TTTCTCGCGCGGACACCCCCGGTCTCATAT
CGTGGTCCGAGAAACCATATGTTATGATAA|TTATGATAATGTCTACTGTAGTAGCCGGGT
GGGTAAGGTTCCCTCTCCGAGTCGCTTTCG|GTATTTTATTATGATTGTTGGGTTAAGGGC
TCCACCAATAACGAGTCCGAGAAACCATAT|GAATGTCAGTGCTTTACTCAGCCTGACCCG
TAGTGCTCACCGTCACCTATCATTTACAAA|ATATGTTATGATAATGTCTTATCCGCCACT
TGTGATTGACTCCGTCCGAGAAACCATATG|ATGTTATGATAATGTCAGAAACCATATGTT
GCAGCAGAGTTCTCAATTTGTCGTGGTCCG|GACGGTCCGAGAAACCATATGTTATGATAA
GTTATGATAATGTCCTGACCGATACGAGAC|ACGAGTCCGAGAAACCATATGTTATGATAA
GTAGGGGTCCGAGAAACCATATGTTATGAT|CGGATAGAACCGATTGCGTAGTCCGAGAGT
GATAAAGCCGATAAAGCTCCCCAAGGGAAT|GTCCCTCTGAGTTCACCGAGTCAGGAGGGC
TATGATAATGTCCTGACCGATACGAGACTG|GAGTCCGAGAAACCATATGTTATGATAATG
TCACCTATCATTTACAAAACTCAGCGCTCA|AATGTCTTATCCGCCACTCATGTAATACAC
ACGGTTTTTACGAACAAACCGCGGTCCGAG|GATGTCAAATGGACCTAAACATTTAAATGT
GTCTTATCCGCCACTCATGTAATACACGTT|CGGTGTTGCCTTTGTGGAGAAATTGACTGT
TCTAAAGACGATGTCAAATGGACCTAAACA|AGTTGGGACAACGTCTTGCGCTAACCCGAC
AACGTAGAACGGTTTTTACGAACAAACCGC|CTAAAGACGATGTCAAATGGACCTAAACAT
GGGAATGTCAGTGCTTTACTCAGCCTGACC|GAGGGCAAATAGCTCTGGGGTACTCGGTTT
CACGTTGGGTAAGGTTCCCTCTCCGAGTCG|GACTGTGTATTTTATTATGATTGTTGGGTT
GACCAATACCTTCACAGACGGTCCGAGAAA|GTTATGATAATGTCAACCATATGTTATGAT
GAAACCATATGTTATGATAATGTCGAATAA|CTGCCTTTTCTCGCGCGGACACCCCCGGTC
CGTAGTCCGAGAGTCCGAGAAACCATATGT|GTTATGATAATGTCTTCAACCCTGGGCTTC
CCCTCTTATGTATGATGTCCCTCCCGATCC|TATGATAATGTCTAGTGCTCACCGTCACCT
CCATATGTTATGATAATGTCGAATAAGTCC|CTTTTCTCGCGCGGACACCCCCGGTCTCAT
ACCTATCATTTACAAAACTCAGCGCTCATG|TGTCTTATCCGCCACTCATGTAATACACGT
ATTGACTGTGTATTTTATTATGATTGTTGG|CTGATCAGGTCAAATGGCTTGAGGCGGTGC
CAGAGTTCTCAATTTGTCGTGGTCCGAGAA|GTCCGAGAAACCATATGTTATGATAATGTC
AGTAGCCGGGTTCGCCCAGCAATGCATGAG|ACGTAGAACGGTTTTTACGAACAAACCGCG
GGCTTCTCATAGTCCCTCCACCAATAACGA|ATAAAGCTCCCCAAGGGAATGTCAGTGCTT
AGCACCCGTTTCGTGTCTTGGACCGAGATT|CCCGATCCGGATGTGTAGCCACCCACAAAG
ACCATATGTTATGATAATGTCCCGAGAAAC|CGCTTATATTCGCGGGTCATGTGGGGGTCT
CACAAAGGTGTCCGGTCCGAGAAACCATAT|CAGCGCTCATGTGAGGTGTCGCTCAAAAGA
ATGTTATGATAATGTCCTGACCGATACGAG|TAACGAGTCCGAGAAACCATATGTTATGAT
GATAATGTCTTATCCGCCACTCATGTAATA|CCAGGGCGGTGTTGCCTTTGTGGAGAAATT
TGATAATGTCCCTCTGAGTTCACCGAGTCA|GAATCCATGTGATTGACTCCGTCCGAGAAA
TCAGTTGGGACAACGTCTTGCGCTAACCCG|CCCTCGCTTAGTGAGCACCCGTTTCGTGTC
TCAGCGCTCATGTGAGGTGTCGCTCAAAAG|TGTAATACACGTTGGGTAAGGTTCCCTCTC
GAGTCGCTTTCGTCCGAGAAACCATATGTT|TGGGTTAAGGGCTGCAACTGCCTTTTCTCG
CCCAGCAATGCATGAGCGGATAGAACCGAT|TTACGAACAAACCGCGGTCCGAGAAACCAT
TGATAATGTCCCGAGAAACCATATGTTATG|GCGGGTCATGTGGGGGTCTAGACAGGGTCC
TAATGTCGCTACAAAGACCAATACCTTCAC|TCCGAGAAACCATATGTTATGATAATGTCA
GAAACCATATGTTATGATAATGTCAGAAAC|GCTCAAAAGACTCACAAAGGTAGGGATACG
AATAACGAGTCCGAGAAACCATATGTTATG|CAGTGCTTTACTCAGCCTGACCCGCAAGGT
CTTATGTATGATGTCCCTCCCGATCCGGAT|ATAATGTCTAGTGCTCACCGTCACCTATCA
TGTCCCTCCCGATCCGGATGTGTAGCCACC|TGCTCACCGTCACCTATCATTTACAAAACT
ATGTGCTTATATCAGGGTCCCTGAGCAGAT|GTCCGAGAAACCATATGTTATGATAATGTC
AAACCATATGTTATGATAATGTCCAGGGCG|GCGCCAATGCGTCTGTCCACCTTGGTGCCG
GATAATGTCCCGAGAAACCATATGTTATGA|CGGGTCATGTGGGGGTCTAGACAGGGTCCG
GCGGTGTCACATATTTGTCCGCAGCAGAGT|CAAAGACCAATACCTTCACAGACGGTCCGA
TGTCACATATTTGTCCGCAGCAGAGTTCTC|GACCAATACCTTCACAGACGGTCCGAGAAA
CCGAGAAACCATATGTTATGATAATGTCTT|AATGTGCTTATATCAGGGTCCCTGAGCAGA
GTTCCCTCTCCGAGTCGCTTTCGTCCGAGA|ATTATGATTGTTGGGTTAAGGGCTGCAACT
TGTCCAGGGCGGTGTTGCCTTTGTGGAGAA|CCTTGGTGCCGCTGAGCCAATTGATACAGT
TTGTGGAGAAATTGACTGTGTATTTTATTA|TTGATACAGTCTGATCAGGTCAAATGGCTT
TATGTTATGATAATGTCAGAAACCATATGT|AGACTCACAAAGGTAGGGATACGCTTATAT
TTATGATAATGTCCTGACCGATACGAGACT|CGAGTCCGAGAAACCATATGTTATGATAAT
AATAGCTCTGGGGTACTCGGTTTGGAATAG|TATGATAATGTCGGCTACGCATTGTTCCCT
TGGGTAAGGTTCCCTCTCCGAGTCGCTTTC|TGTATTTTATTATGATTGTTGGGTTAAGGG
CCGATCCGGATGTGTAGCCACCCACAAAGG|GTCACCTATCATTTACAAAACTCAGCGCTC
GGGTACTCGGTTTGGAATAGCATGCCCCTC|TCGGCTACGCATTGTTCCCTCTTATGTATG
AATGTCTACTGTAGTAGCCGGGTTCGCCCA|TACGAGACTGCAACGTAGAACGGTTTTTAC
ATGTTATGATAATGTCAGAAACCATATGTT|GACTCACAAAGGTAGGGATACGCTTATATT
GATACGCTTATATTCGCGGGTCATGTGGGG|CGAGAAACCATATGTTATGATAATGTCGAA
TATGATAATGTCGCTACAAAGACCAATACC|GAGAGTCCGAGAAACCATATGTTATGATAA
AGAAACCATATGTTATGATAATGTCCCTCT|TGGCCGAACATGTAGGAATCCATGTGATTG
TCTTGCGCTAACCCGACGTTGAGTCCGAGA|CACCCGTTTCGTGTCTTGGACCGAGATTGG
CATATGTTATGATAATGTCCTGACCGATAC|CAATAACGAGTCCGAGAAACCATATGTTAT
CCATATGTTATGATAATGTCTTATCCGCCA|TATGATAATGTCCAGGGCGGTGTTGCCTTT
TGATAATGTCTTATCCGCCACTCATGTAAT|TCCAGGGCGGTGTTGCCTTTGTGGAGAAAT
GTTATGATAATGTCCAGGGCGGTGTTGCCT|CGTCTGTCCACCTTGGTGCCGCTGAGCCAA
CTCATGTGAGGTGTCGCTCAAAAGACTCAC|ACACGTTGGGTAAGGTTCCCTCTCCGAGTC
CGAGAAACCATATGTTATGATAATGTCAGA|GTCGCTCAAAAGACTCACAAAGGTAGGGAT
ATGTTATGATAATGTCTAAAGACGATGTCA|CGCAAGGTTCGGTCAGTTGGGACAACGTCT
ATGATAATGTCGAATAAGTCCGAGAAACCA|CGCGGACACCCCCGGTCTCATATGGCGCCA
AACCATATGTTATGATAATGTCCCTCTGAG|CCGAACATGTAGGAATCCATGTGATTGACT
CTTATCCGCCACTCATGTAATACACGTTGG|GTGTTGCCTTTGTGGAGAAATTGACTGTGT
GACCTAAACATTTAAATGTGCTTATATCAG|CTAACCCGACGTTGAGTCCGAGAAACCATA
TGTCTACTGTAGTAGCCGGGTTCGCCCAGC|CGAGACTGCAACGTAGAACGGTTTTTACGA
ACGTTGAGTCCGAGAAACCATATGTTATGA|TTGGACCGAGATTGGCCGAACATGTAGGAA
ATCCGGATGTGTAGCCACCCACAAAGGTGT|ACCTATCATTTACAAAACTCAGCGCTCATG
GATAATGTCGGCTACGCATTGTTCCCTCTT|TAATGTCCCGAGAAACCATATGTTATGATA
AATGTCTAGTGCTCACCGTCACCTATCATT|GAAACCATATGTTATGATAATGTCTTATCC
CAGCGCTCATGTGAGGTGTCGCTCAAAAGA|GTAATACACGTTGGGTAAGGTTCCCTCTCC
CAAAGACCAATACCTTCACAGACGGTCCGA|ATATGTTATGATAATGTCAACCATATGTTA
AATAGCATGCCCCTCGCTTAGTGAGCACCC|TCCCTCTTATGTATGATGTCCCTCCCGATC
CACAGACGGTCCGAGAAACCATATGTTATG|TCAACCATATGTTATGATAATGTCCTGACC
TTATGATAATGTCATACACCATGCACTGGT|TAGCCGGGTTCGCCCAGCAATGCATGAGCG
GGTGTCGCTCAAAAGACTCACAAAGGTAGG|GTAAGGTTCCCTCTCCGAGTCGCTTTCGTC
GTTATGATAATGTCATACACCATGCACTGG|GTAGCCGGGTTCGCCCAGCAATGCATGAGC
AGATTGGCCGAACATGTAGGAATCCATGTG|CAAAGGTGTCCGGTCCGAGAAACCATATGT
GACGGTCCGAGAAACCATATGTTATGATAA|CCATATGTTATGATAATGTCCTGACCGATA
AGTCCGAGAAACCATATGTTATGATAATGT|CGAGATTGGCCGAACATGTAGGAATCCATG
TATGATAATGTCCCGAGAAACCATATGTTA|TCGCGGGTCATGTGGGGGTCTAGACAGGGT
GACTCACAAAGGTAGGGATACGCTTATATT|CCGAGTCGCTTTCGTCCGAGAAACCATATG
AGAAACCATATGTTATGATAATGTCTACTG|ATGATAATGTCCTGACCGATACGAGACTGC
ATATTTGTCCGCAGCAGAGTTCTCAATTTG|TACCTTCACAGACGGTCCGAGAAACCATAT
AATGTCCAGGGCGGTGTTGCCTTTGTGGAG|CACCTTGGTGCCGCTGAGCCAATTGATACA
CTCAGCGCTCATGTGAGGTGTCGCTCAAAA|ATGTAATACACGTTGGGTAAGGTTCCCTCT
CTCTGAGTTCACCGAGTCAGGAGGGCAAAT|ATTGACTCCGTCCGAGAAACCATATGTTAT
GCAGAGTTCTCAATTTGTCGTGGTCCGAGA|GGTCCGAGAAACCATATGTTATGATAATGT
TGATAATGTCCAGGGCGGTGTTGCCTTTGT|TGTCCACCTTGGTGCCGCTGAGCCAATTGA
AATCCATGTGATTGACTCCGTCCGAGAAAC|AACCATATGTTATGATAATGTCAGAAACCA
TTCGTCCGAGAAACCATATGTTATGATAAT|GGGCTGCAACTGCCTTTTCTCGCGCGGACA
AACATGTAGGAATCCATGTGATTGACTCCG|CGGTCCGAGAAACCATATGTTATGATAATG
TAATGTCAGAAACCATATGTTATGATAATG|AGGTAGGGATACGCTTATATTCGCGGGTCA
CTGGGGTACTCGGTTTGGAATAGCATGCCC|ATGTCGGCTACGCATTGTTCCCTCTTATGT
TAGGAATCCATGTGATTGACTCCGTCCGAG|GAGAAACCATATGTTATGATAATGTCAGAA
ATGTTATGATAATGTCCCTCTGAGTTCACC|ATGTAGGAATCCATGTGATTGACTCCGTCC
CGATTGCGTAGTCCGAGAGTCCGAGAAACC|CCATATGTTATGATAATGTCTTCAACCCTG
GGAATCCATGTGATTGACTCCGTCCGAGAA|GAAACCATATGTTATGATAATGTCAGAAAC
CTACGCATTGTTCCCTCTTATGTATGATGT|GAAACCATATGTTATGATAATGTCTAGTGC
GTAGCCGGGTTCGCCCAGCAATGCATGAGC|CGTAGAACGGTTTTTACGAACAAACCGCGG
CGAGAAACCATATGTTATGATAATGTCTAA|TCAGCCTGACCCGCAAGGTTCGGTCAGTTG
GTGCTTATATCAGGGTCCCTGAGCAGATAA|CCGAGAAACCATATGTTATGATAATGTCCC
TATTCGCGGGTCATGTGGGGGTCTAGACAG|TATGTTATGATAATGTCGAATAAGTCCGAG
CCTGACCCGCAAGGTTCGGTCAGTTGGGAC|TCGGTTTGGAATAGCATGCCCCTCGCTTAG
GAAACCATATGTTATGATAATGTCTTCAAC|TGCTTATATCAGGGTCCCTGAGCAGATAAA
TGATAATGTCATACACCATGCACTGGTAGG|CCGGGTTCGCCCAGCAATGCATGAGCGGAT
TGTCAGTGCTTTACTCAGCCTGACCCGCAA|CAAATAGCTCTGGGGTACTCGGTTTGGAAT
GACGTTGAGTCCGAGAAACCATATGTTATG|CTTGGACCGAGATTGGCCGAACATGTAGGA
TTGACTCCGTCCGAGAAACCATATGTTATG|ATGATAATGTCAGAAACCATATGTTATGAT
GTATGATGTCCCTCCCGATCCGGATGTGTA|GTCTAGTGCTCACCGTCACCTATCATTTAC
GCTTTACTCAGCCTGACCCGCAAGGTTCGG|CTCTGGGGTACTCGGTTTGGAATAGCATGC
GTCGCTACAAAGACCAATACCTTCACAGAC|AGAAACCATATGTTATGATAATGTCAACCA
TGTCTTCAACCCTGGGCTTCTCATAGTCCC|AGCAGATAAAGCCGATAAAGCTCCCCAAGG
TATATTCGCGGGTCATGTGGGGGTCTAGAC|CATATGTTATGATAATGTCGAATAAGTCCG
AGTCCGAGAAACCATATGTTATGATAATGT|GTCTTCAACCCTGGGCTTCTCATAGTCCCT
TGTATTTTATTATGATTGTTGGGTTAAGGG|GTCAAATGGCTTGAGGCGGTGCGCGGCCCG
CGTCTTGCGCTAACCCGACGTTGAGTCCGA|AGCACCCGTTTCGTGTCTTGGACCGAGATT
TCGCCCAGCAATGCATGAGCGGATAGAACC|TTTTTACGAACAAACCGCGGTCCGAGAAAC
GATTGACTCCGTCCGAGAAACCATATGTTA|TTATGATAATGTCAGAAACCATATGTTATG
CGCTCAAAAGACTCACAAAGGTAGGGATAC|GTTCCCTCTCCGAGTCGCTTTCGTCCGAGA
CAAGGGAATGTCAGTGCTTTACTCAGCCTG|CAGGAGGGCAAATAGCTCTGGGGTACTCGG
CAGAAACCATATGTTATGATAATGTCCCGA|GGATACGCTTATATTCGCGGGTCATGTGGG
GTTATGATAATGTCTTATCCGCCACTCATG|AATGTCCAGGGCGGTGTTGCCTTTGTGGAG
TACTCGGTTTGGAATAGCATGCCCCTCGCT|GCTACGCATTGTTCCCTCTTATGTATGATG
CTGGTAGGGGTCCGAGAAACCATATGTTAT|GAGCGGATAGAACCGATTGCGTAGTCCGAG
CAACCATATGTTATGATAATGTCCTGACCG|CCACCAATAACGAGTCCGAGAAACCATATG
TGTTCCCTCTTATGTATGATGTCCCTCCCG|ATGTTATGATAATGTCTAGTGCTCACCGTC
TATGTTATGATAATGTCCTGACCGATACGA|ATAACGAGTCCGAGAAACCATATGTTATGA
ATGTTATGATAATGTCCCGAGAAACCATAT|ATATTCGCGGGTCATGTGGGGGTCTAGACA
GTTATGATAATGTCTAGTGCTCACCGTCAC|GGGTCCGAGAAACCATATGTTATGATAATG
ATATGTTATGATAATGTCCCGAGAAACCAT|TTATATTCGCGGGTCATGTGGGGGTCTAGA
ATGATAATGTCATACACCATGCACTGGTAG|GCCGGGTTCGCCCAGCAATGCATGAGCGGA
CAAATGGACCTAAACATTTAAATGTGCTTA|CTTGCGCTAACCCGACGTTGAGTCCGAGAA
CAGACGGTCCGAGAAACCATATGTTATGAT|AACCATATGTTATGATAATGTCCTGACCGA
ATAATGTCAGAAACCATATGTTATGATAAT|AAGGTAGGGATACGCTTATATTCGCGGGTC
GGTTTTTACGAACAAACCGCGGTCCGAGAA|TGTCAAATGGACCTAAACATTTAAATGTGC
TCATACACCATGCACTGGTAGGGGTCCGAG|GCCCAGCAATGCATGAGCGGATAGAACCGA
ACGTTGGGTAAGGTTCCCTCTCCGAGTCGC|ACTGTGTATTTTATTATGATTGTTGGGTTA
ACCGATTGCGTAGTCCGAGAGTCCGAGAAA|AACCATATGTTATGATAATGTCTTCAACCC
CACATATTTGTCCGCAGCAGAGTTCTCAAT|CAATACCTTCACAGACGGTCCGAGAAACCA
GGTAGGGGTCCGAGAAACCATATGTTATGA|GCGGATAGAACCGATTGCGTAGTCCGAGAG
TATGTTATGATAATGTCGCTACAAAGACCA|AGTCCGAGAGTCCGAGAAACCATATGTTAT
AACCATTTTGTGGGCTGCGGTGTCACATAT|TATGATAATGTCGCTACAAAGACCAATACC
TCCCTCCACCAATAACGAGTCCGAGAAACC|AAGGGAATGTCAGTGCTTTACTCAGCCTGA
TGTTATGATAATGTCGCTACAAAGACCAAT|TCCGAGAGTCCGAGAAACCATATGTTATGA
CATATGTTATGATAATGTCAACCATATGTT|GGGCTTCTCATAGTCCCTCCACCAATAACG
ACCATATGTTATGATAATGTCGGCTACGCA|CATATGTTATGATAATGTCCCGAGAAACCA
GTCCGAGAAACCATATGTTATGATAATGTC|AACCATATGTTATGATAATGTCCAGGGCGG
GTCTTGGACCGAGATTGGCCGAACATGTAG|GTAGCCACCCACAAAGGTGTCCGGTCCGAG
ACCATATGTTATGATAATGTCAACCATATG|CTGGGCTTCTCATAGTCCCTCCACCAATAA
GGTTCGGTCAGTTGGGACAACGTCTTGCGC|AGCATGCCCCTCGCTTAGTGAGCACCCGTT
GAGCACCCGTTTCGTGTCTTGGACCGAGAT|TCCCGATCCGGATGTGTAGCCACCCACAAA
GCTACGCATTGTTCCCTCTTATGTATGATG|AGAAACCATATGTTATGATAATGTCTAGTG
ATAATGTCCTGACCGATACGAGACTGCAAC|CCGAGAAACCATATGTTATGATAATGTCTA
TGAGCAGATAAAGCCGATAAAGCTCCCCAA|GATAATGTCCCTCTGAGTTCACCGAGTCAG
GAGATTGGCCGAACATGTAGGAATCCATGT|ACAAAGGTGTCCGGTCCGAGAAACCATATG
CCTTTGTGGAGAAATTGACTGTGTATTTTA|CAATTGATACAGTCTGATCAGGTCAAATGG
TACGAACAAACCGCGGTCCGAGAAACCATA|ATGGACCTAAACATTTAAATGTGCTTATAT
ACGATGTCAAATGGACCTAAACATTTAAAT|ACAACGTCTTGCGCTAACCCGACGTTGAGT
TTCACCGAGTCAGGAGGGCAAATAGCTCTG|CCGTCCGAGAAACCATATGTTATGATAATG
AAACCATATGTTATGATAATGTCCCTCTGA|GCCGAACATGTAGGAATCCATGTGATTGAC
GAGTCCGAGAAACCATATGTTATGATAATG|CCGAGATTGGCCGAACATGTAGGAATCCAT
TTATGATAATGTCCCTCTGAGTTCACCGAG|TAGGAATCCATGTGATTGACTCCGTCCGAG
GTCCGCAGCAGAGTTCTCAATTTGTCGTGG|CACAGACGGTCCGAGAAACCATATGTTATG
TCAGTGCTTTACTCAGCCTGACCCGCAAGG|AATAGCTCTGGGGTACTCGGTTTGGAATAG
CTTTCGTCCGAGAAACCATATGTTATGATA|AAGGGCTGCAACTGCCTTTTCTCGCGCGGA
TGTAGTAGCCGGGTTCGCCCAGCAATGCAT|GCAACGTAGAACGGTTTTTACGAACAAACC
CAGCCTGACCCGCAAGGTTCGGTCAGTTGG|TACTCGGTTTGGAATAGCATGCCCCTCGCT
CCTATCATTTACAAAACTCAGCGCTCATGT|GTCTTATCCGCCACTCATGTAATACACGTT
AACAAACCGCGGTCCGAGAAACCATATGTT|ACCTAAACATTTAAATGTGCTTATATCAGG
CGGATAGAACCGATTGCGTAGTCCGAGAGT|GTCCGAGAAACCATATGTTATGATAATGTC
TGAGGTGTCGCTCAAAAGACTCACAAAGGT|TGGGTAAGGTTCCCTCTCCGAGTCGCTTTC
CCACAAAGGTGTCCGGTCCGAGAAACCATA|TCAGCGCTCATGTGAGGTGTCGCTCAAAAG
GGTGTCACATATTTGTCCGCAGCAGAGTTC|AAGACCAATACCTTCACAGACGGTCCGAGA
GTGCTCACCGTCACCTATCATTTACAAAAC|ATGTTATGATAATGTCTTATCCGCCACTCA
CGAGAAACCATATGTTATGATAATGTCAAC|TCAACCCTGGGCTTCTCATAGTCCCTCCAC
ACGAGTCCGAGAAACCATATGTTATGATAA|GCTTTACTCAGCCTGACCCGCAAGGTTCGG
CCCTGAGCAGATAAAGCCGATAAAGCTCCC|TATGATAATGTCCCTCTGAGTTCACCGAGT
GCAATGCATGAGCGGATAGAACCGATTGCG|GAACAAACCGCGGTCCGAGAAACCATATGT
CACCAATAACGAGTCCGAGAAACCATATGT|ATGTCAGTGCTTTACTCAGCCTGACCCGCA
TGCTCACCGTCACCTATCATTTACAAAACT|TGTTATGATAATGTCTTATCCGCCACTCAT
TGTTATGATAATGTCCCGAGAAACCATATG|TATTCGCGGGTCATGTGGGGGTCTAGACAG
TAATGTCTAGTGCTCACCGTCACCTATCAT|AGAAACCATATGTTATGATAATGTCTTATC
TCGTGTCTTGGACCGAGATTGGCCGAACAT|ATGTGTAGCCACCCACAAAGGTGTCCGGTC
CCGAACATGTAGGAATCCATGTGATTGACT|GTCCGGTCCGAGAAACCATATGTTATGATA
CCGAGAAACCATATGTTATGATAATGTCGA|GCAACTGCCTTTTCTCGCGCGGACACCCCC
TATGTTATGATAATGTCCAGGGCGGTGTTG|ATGCGTCTGTCCACCTTGGTGCCGCTGAGC
CATATGTTATGATAATGTCGCTACAAAGAC|GTAGTCCGAGAGTCCGAGAAACCATATGTT
ACCATATGTTATGATAATGTCTACTGTAGT|TAATGTCCTGACCGATACGAGACTGCAACG
ATAATGTCTAGTGCTCACCGTCACCTATCA|GAGAAACCATATGTTATGATAATGTCTTAT
GAGAAACCATATGTTATGATAATGTCTACT|TATGATAATGTCCTGACCGATACGAGACTG
TGCGCTAACCCGACGTTGAGTCCGAGAAAC|CCGTTTCGTGTCTTGGACCGAGATTGGCCG
ATAATGTCATACACCATGCACTGGTAGGGG|GGGTTCGCCCAGCAATGCATGAGCGGATAG
ACCGATACGAGACTGCAACGTAGAACGGTT|TATGTTATGATAATGTCTAAAGACGATGTC
GCAGATAAAGCCGATAAAGCTCCCCAAGGG|AATGTCCCTCTGAGTTCACCGAGTCAGGAG
ATATGTTATGATAATGTCAACCATATGTTA|GGCTTCTCATAGTCCCTCCACCAATAACGA
TTATATTCGCGGGTCATGTGGGGGTCTAGA|CCATATGTTATGATAATGTCGAATAAGTCC
ATGTCTAGTGCTCACCGTCACCTATCATTT|AAACCATATGTTATGATAATGTCTTATCCG
GGCAAATAGCTCTGGGGTACTCGGTTTGGA|ATGTTATGATAATGTCGGCTACGCATTGTT
GATAATGTCCTGACCGATACGAGACTGCAA|TCCGAGAAACCATATGTTATGATAATGTCT
TCATAGTCCCTCCACCAATAACGAGTCCGA|CTCCCCAAGGGAATGTCAGTGCTTTACTCA
ATAGCATGCCCCTCGCTTAGTGAGCACCCG|CCCTCTTATGTATGATGTCCCTCCCGATCC
TGATAATGTCGAATAAGTCCGAGAAACCAT|GCGGACACCCCCGGTCTCATATGGCGCCAA
ACCCGCAAGGTTCGGTCAGTTGGGACAACG|TTTGGAATAGCATGCCCCTCGCTTAGTGAG
AATGTCAACCATATGTTATGATAATGTCCT|TCCCTCCACCAATAACGAGTCCGAGAAACC
TTTACTCAGCCTGACCCGCAAGGTTCGGTC|CTGGGGTACTCGGTTTGGAATAGCATGCCC
ATGTCTTATCCGCCACTCATGTAATACACG|GGCGGTGTTGCCTTTGTGGAGAAATTGACT
GTCCCTGAGCAGATAAAGCCGATAAAGCTC|GTTATGATAATGTCCCTCTGAGTTCACCGA
ACCATATGTTATGATAATGTCATACACCAT|TACTGTAGTAGCCGGGTTCGCCCAGCAATG
TGTCCTGACCGATACGAGACTGCAACGTAG|GAAACCATATGTTATGATAATGTCTAAAGA
GACTGTGTATTTTATTATGATTGTTGGGTT|ATCAGGTCAAATGGCTTGAGGCGGTGCGCG
CTCCCGATCCGGATGTGTAGCCACCCACAA|ACCGTCACCTATCATTTACAAAACTCAGCG
GAAACCATATGTTATGATAATGTCTACTGT|TGATAATGTCCTGACCGATACGAGACTGCA
CGCTCATGTGAGGTGTCGCTCAAAAGACTC|ATACACGTTGGGTAAGGTTCCCTCTCCGAG
TCTCATAGTCCCTCCACCAATAACGAGTCC|AGCTCCCCAAGGGAATGTCAGTGCTTTACT
TGGGCTGCGGTGTCACATATTTGTCCGCAG|TCGCTACAAAGACCAATACCTTCACAGACG
AGTGCTTTACTCAGCCTGACCCGCAAGGTT|TAGCTCTGGGGTACTCGGTTTGGAATAGCA
CCATATGTTATGATAATGTCCCGAGAAACC|GCTTATATTCGCGGGTCATGTGGGGGTCTA
CGCTAACCCGACGTTGAGTCCGAGAAACCA|GTTTCGTGTCTTGGACCGAGATTGGCCGAA
GAAACCATATGTTATGATAATGTCTAAAGA|GCCTGACCCGCAAGGTTCGGTCAGTTGGGA
TGCCCCTCGCTTAGTGAGCACCCGTTTCGT|TATGTATGATGTCCCTCCCGATCCGGATGT
GAGCAGATAAAGCCGATAAAGCTCCCCAAG|ATAATGTCCCTCTGAGTTCACCGAGTCAGG
AATACACGTTGGGTAAGGTTCCCTCTCCGA|AATTGACTGTGTATTTTATTATGATTGTTG
ATGTCGGCTACGCATTGTTCCCTCTTATGT|GTCCCGAGAAACCATATGTTATGATAATGT
TCCGAGTCGCTTTCGTCCGAGAAACCATAT|TGTTGGGTTAAGGGCTGCAACTGCCTTTTC
TAAAGACGATGTCAAATGGACCTAAACATT|TTGGGACAACGTCTTGCGCTAACCCGACGT
